text	label
洗完不干，非常舒服，就是手洗完了有点脱皮。不知道是不是因为是碱性的原因	positive
款式好看，抗震性好，在运动场和柏油路上都跑过，鞋底稍硬！	positive
为旅游方便买的，有很刺鼻的味道，跟大瓶装确实不一样。失望	negative
这个是猪皮的,容易变形,~~~~(>_<)~~~~	negative
垃圾亚马逊，发票到现在都收不到，中间还少发卡，垃圾。	negative
送货太慢了，到了学校，货还没到家，呜呜呜	negative
少了30页内容，220～253页，重复两遍。唉	negative
花16000这么贵的马桶，用了不到2个月，打客服打了好几天，都没人接。这样的亚马逊售后，无语	negative
机子很不错，之前有一台fenix3蓝宝石屏，不用担心刮花，以为这台也不会差到哪去，谁知没几天屏幕就被我弄了朵小花在上面，所以赶紧贴膜。按上面两位的标准步骤（汉化，装地图，纠偏等）还有小胖熊的支持，机子终于发挥出强大威力。搜星很快，电池用eneloop pro一天完全没问题，买了张32g的金士顿tf卡用来装地图。机子本身没有温度感应器，需花两百多另购，大部分我所需要的功能都与fenix3重合了，所以出掉了手表，以后就专门用这个了，因为这个能装地图，手表只能告诉你回去的路，而这个可以指引你想走的路，这也是买这台机子最重要的原因。	positive
不错，是这个焦段的黄金镜头。适应性很好。	positive
内容不错，信息量较大，有些像教科书形式，可能小童鞋们认为不够生动。唯一可惜的是没有配套的MP3，旧版好像是有磁带的。	positive
不值，机子上水塔是塑料的 ，根本不值这个价钱。需要的买家谨慎入手。	negative
同事让我帮忙买的，她拿给男友的，同事自己反正很满意哈，哈哈	positive
我头发很燥，我一直在找洗完头发不要用护发素的洗发水，这款就很适合我，洗完头发很顺，可以省去护发素的步骤。	positive
等了很久终于来了，虽然知道种玉米很辛苦，快递员也很辛苦，大热天的，但玉米有的很老，有的嫩的稀稀拉拉只有部分粒，怎么说呐，还是很辛苦的！为辛苦赞一个！	negative
感觉真的不适合我，太薄了，而且不好扣紧，显然是耐克这个牌子蒙蔽了我的眼。	negative
有点大了，按照专卖店的码数买的，比专卖店的码大一点	positive
最初说是5日送达，后改为11日，今天已是15日，还未送到，也不知道上哪溜达了。	negative
送过来 衣服有很多线头,还有极不合身,然后要求商家退货,还说不承担回运费,要自己出,卖的衣服这么差,纯粹是骗人给运费的,大家千万不要买这家商店的衣服.!!!!!!!!!!!!!!!!!切记	negative
很棒，外观的龙看起来超喜感，纸张洁白厚实，还有很多漂亮插图。比起其他网站价格便宜多了。唯一缺点是最后大地图位置不好。	positive
各方面的看法肯定是不一样的，注重的角度也不一样，多看看肯定有好处。	positive
去年11月买的，前一天晚上用都还是好的，今早就坏了，不通电完全没反应，以前买的杂牌煮蛋器都用了近两年，这个一年都没用到	negative
还好，戴着不是很舒服；不知道是不是正品？	positive
纸张和印刷不错，但内容贫乏，特别是对各学院的介绍过于简单，也没有必要用中英双语。如果突出画册属性，对每张图片应该有个介绍，有故事就更好了，而不是把一堆照片摆在那里，搞的读者一头雾水，不值所云，这些照片在网上都搜得到。此外作者个人的照片太多了，虽然作者比高老师那张脸好多了，但读者并不感兴趣。	negative
物流很快，隔了一天就到了，会向其他朋友推荐在这里买书	positive
质量很好的班，很适合一日游，对得起这个价格	negative
光盘后面听不了。给一星是因为没有更低了。真差	negative
是一本少见的从心理层面分析剧本创作的书，值得一读。但不够详细。	positive
虽是亚马逊订单，但是发票却不由亚马逊开出，最开始也没有讲清楚，因为报销问题一定要纸质发票于是只能快递发票，快递费用需要自己倒贴。总觉得不合理。	negative
两次图片丢失.，害死人了，不知道向哪里投诉！	negative
不过在插进电脑接口之后，没一会儿U盘就发烫了。	positive
冲着花王的品牌买的，但是喷出的泡沫没有预期的多，清洁效果还可以。	positive
就是发票到现在还没有到。 不知道哪个环节出了问题。 有点郁闷。	positive
包装很到位，还没喝，扫过码了…不错，满意	positive
手表用到不到半年表盘掉落 寄过去维修说要钱 手表才多少钱 售后还是京东好 以后再也不会在亚马逊买电子产品	negative
内容太细致了，根本没时间看完啊，东西不错	positive
朋友推荐用来练字的，就买了，但是太多了，又不能只买5支，既然要收运费就应该可以选择数量才对，所以感觉不太好。 另一方面，买完立马降价什么意思？？？58买完就降到40了？？？ 当然最重要的还是写起来不怎么流畅。。。	negative
看了内容简介才买的，应该不错，希望看了有所收获	positive
用了一两周了，脸上的大包包有改善。坚持用。	positive
透气性不太好，闷脚，走路时脚后跟处咯吱咯吱响！挺烦人的！	negative
这本书整体性不强，而是设计师的一些小故事和人生感受。比较有趣。	positive
用后没电了，充电后不知是没冲上还是什么原因，就再用不了了。想找厂家咨询，也没有电话。。。	negative
冰块还没做过，但用来烤东西不方便，很难完整地弄出来	negative
很重，份量很足，打开包装，龙头质量很好，还没装，期待装上后的效果	positive
书中有许多话语，能产生共鸣，能从书中有所收获就是好书，这本书做到了。虽然网上对此书有一些争议，但是我依然推荐这本书。	positive
很软，但是亚马逊的内裤，都很小，都不知道怎么回事	positive
送货准时，书的质量也很不错，小朋友非常喜欢。	positive
长时间未收到货，店家反馈不积极，每次都是投诉到亚马逊，才给回复	negative
这一部有点赶工的感觉，作者前面不断挖坑，但最后有些没填。。。 从第一部开始，作者看问题确实比较犀利，阴谋论虽然显得比较阴暗，但顺着作者的思路，确实解释了很多以前中学读历史留下的疑惑，比如慈禧的反复无常，比如戊戌变法的真相，比如大清集合这么多部队还是打不过洋人的原因。 这本书属于通俗读物，强调史料的真实准确性的，凡事都要讲出处的就不要读这本书了；建议读的时候也要辩证地吸收作者的观点。	positive
一本书，胜过十年政治课。可惜关键内容给删了。	positive
画风很好，很鲜艳明亮，就是翻译得感觉很拗口，还是应该买原版的	positive
用了还不到两月，包包的手提就坏了，真让人恶心。	negative
讲稿生动，装帧也很适合学习，在中医学习路上，觉得这本书会有很大的启发	positive
穿起来跑步脚底很滑，不舒服。6月14下单购买，26号才收到，不清楚卖家是不是不想出运费，是自己送过来的。	negative
不想换了，麻烦，寄过来的时候底部凹了一下，上面盖子又盖不稳，	negative
买了看过几次，讲解的太抽象，初学着不适用	positive
这本书虽然没有什么特别深的内容，只是说每个小朋友都有不要上幼儿园的时候，都有自己不要去幼儿园的原因，别的什么都没说，但是书的最后一页，画的是他们在幼儿园里玩的特别开心的一个画面。我觉得小朋友看了，会知道，哦，原来不是只有我自己有时候不想上幼儿园，每个小朋友都一样，都有自己的烦恼	positive
酒还没喝，不评论。单说这包装实在是太差了，外箱是破的，酒盒是松散的，快递刚到我都怀疑是从垃圾堆里捡来的，一路过来酒没破简直是奇迹。	negative
扯得太远，花了很长时间才看完。没有什么意义！	negative
之前给妈妈买的6.5码的，她说穿着紧，就是鞋口的地方太紧，于是我买了7码加宽，结果她说太大了，身边39鞋子的阿姨穿着也大。。。只是大了半码区别怎么这样大，另外，妈妈的脚是37.5或者37码的。。。。	negative
本来还很忐忑犹豫，现在看来宝贝是正品很棒	positive
如果你只是打算饭后茶余翻看，可以买一本看看。如果你打算正襟危坐到书房，秉着研究的态度了解道教文化和历史，建议不要买了。这书谈不上什么严肃认真的研究态度。	negative
小小的收纳盒放茶几上很方便，还蛮精致的。	positive
书是影印的，照片很不清楚，物流居然不打电话通知你，晕！	negative
用了一年都不到，所有的皮都掉出来了一看就不是正品，对亚马逊很失望	negative
不是很理想，用了一个月了，还是有味道，没办法在给宝宝用了。气愤	negative
这本书内容很适合分手的人，也适合处于叛逆期的孩子，更加适合父母。	positive
因为是考研用，一拿到就开始阅读笔记了，也就不好退了，读了半本书了，有遇到几处不是少字就是多字，而且挺可疑的，错得有些离谱	negative
2016年4月过期，怪不得卖这么便宜，原来是临近保质期的，也好意思拿出来做秒杀	negative
商品已查收。美中不足的一点——售价比定价还高。定价是12.00元，这卖家售价12.20元。不厚道。 商品本身很好，里面有临摹的薄纸。从基本笔画说明和练习开始，到字母，再到单词和短语，最后是段落和应用文写作实践，由浅入深，通俗易懂，老少皆宜。good enough。	positive
发货很快 头天拍第二天就送到了 质量还行 对得起这个价格	negative
质量颜色都不错，175 65kg选的S刚好	positive
书本身不错。希望能梳理一下故事发生的顺序重新排序，不然看得有点奇怪。还有翻译明显是几个人分开翻的都没有仔细核对，记者和警官的名字一本跟一本不一样，这是出版社的锅也没办法	positive
非常糟糕的购物体验，货品质地糟糕，收货时间为两三个月时间，非常失败的购	negative
收到的笔记本配置和网上说明有差距，怎么会无独立显卡，这不是忽悠人么？	negative
款式和颜色比较漂亮，手感和纹路明显不是真皮但还是收下了。用了一个多月，不小心被指甲油泼洒腐蚀，如图，一看就是一层薄皮革，绝对不是真皮的。	negative
原本【预计送达日期】显示为2月8日，还在担忧不在家如何收货，没想到今天就送到了，距离下单成功过去了10天，距离发货过去了7天，速度很给力！	positive
和照片的颜色差别非常大，而且号码偏大，质地也非常一般。像劳保用品店里的棉衣！尽量不要购买了。退货流程繁琐，周期非常长。让人望而却步。	negative
没有想象中好用，不单是效果没有，很容易引起头昏，慎买！！！	negative
快递太差劲，没送来就帮我签收了，本着相互理解的想法，觉得快递小哥也不容易，我也没说啥，结果第二天又没送，各种理由和借口，第三天又不说明具体配送时间，难道我要一直在家等着你吗？就因为我好说话就这么折腾人吗？那我以后还是不要好说话了，下次在提前签收试试看，投诉死你，简直了，太不像话了	negative
第一次在亚马逊购买书，太失望了。纸质很差很黄很薄，最重要是还皱巴巴的，以后不再回顾亚马逊了	negative
质量很不错，对宝宝皮肤没有什么刺激，很满意，包装很不错，卖家服务态度很好，快递很给力	positive
要求尽快退货，《北大授课》和《中华文化四十八堂课》内容一样，我两本都买了，这是误导大量爱书之人...	positive
1、物流快，服务好； 2、书的页码有漏印现象，但不影响阅读	positive
很不错，经济实惠，卡片很多，而且还是常见的东西，小宝现在能认不少东西了，赞	positive
感觉没有原版写的好，而且原来的封面比这个摸起来要有感觉一些，推荐大家去书店买，价格也没隔多远	negative
我和朋友读这本书给小孩子时自己也蛮喜欢的。物有所值，图片可爱，精致，内容主要告诉孩子学习适应新环境会有惊喜，也许更好。书蛮大本的，显得字体过小，字体大一些会更适合儿童书。	positive
外观非常漂亮大气的一款手表，物美价廉，是一个非常不错的选择	positive
等了大概十多天，但收到的时候就已经不精神了，个头也不大，不够甜。 问了线下的水果行，个头又大又甜的，才50块一斤而已。	negative
刷完了八九遍了，进口的确实不敢与平日的书同语，硬刷质量不错，但是送货的包装只能用可怜两字形容——外面只有一层薄薄的包装袋，这也是两百多的书啊，这样的待遇是不是也未免太冷了	positive
被多次强行之乎者也的句子打击之后，鄙人停在了49%，再见	negative
宝宝不太喜欢，偶尔吸吸，但经常掉，一掉就哭	negative
还以为是有肩带的结果没有哎，大小倒是很合适的，做工精致，可惜没肩带	positive
快递送来之后 琴没有损坏 非常开心 还没有用 感觉不错 做工挺细腻的	positive
做工很粗糙 全塑料 太轻 没有图片效果 音效一般 浙江产	negative
第一个寄过来的表面污损，然后放进打印机用不了，电脑提示错误；后来联系卖家换，态度很好，很快寄了一个新的过来，说让我把旧的寄回去，他们补邮费。我信守承诺寄了，人家再无音讯。我以善意猜测人家可能忘记了吧；若是恶意为之，那么人品也就值个快递钱，跟这样人计较什么。	negative
绝对的好评，从来没想过会计竟能以如此故事般的形式展现在人们面前，在趣味中了解一个个原本枯燥的会计概念。	positive
了解历史，从外国人的眼睛，从现代的视角看古老的中国，挺有意思的事。	positive
鞋垫里的漆掉色是什么意思啊？ 是不是假的呢？大家心里都有数	negative
好，以前从不去评价，不知道浪费了多少积分，现在知道积分可以换钱，就要好好评价了，后来我就把这段话复制走了，既能赚积分，还省事，走到哪复制到哪，最重要的是，不用认真的评论了，不用想还差多少字，直接发出就可以了，推荐给大家	positive
我这书都邮了快一个月了，到现在还没收到 打了两次客服也不管用，都说在帮我核实，之后就杳无音信了，对你们亚马逊真是失望至极，下次再也不从你们这买东西了！！！！！	negative
书我是买来收藏的 可是亚马逊包装能不能升级一下 老是塑料袋什么保护措施都没有 暴力快递把书都磨破啦 作为书迷真心难过	positive
内容浅显易懂实用。示例图的花卉都好美，很适合喜欢自然的人啊。	positive
没看评论就买了，果然是中国制造，就连包装不换一个，我劝给为不要买，我也是之前挺相信亚马逊的没想到也是垃圾，这不是欺负中国人吗？还是怎么样？尼玛，怒不可遏啊！	negative
根本不是给我发的图片上的东西。马上过期的，还有一股味道，根本不敢给孩子吃	negative
自从亚马逊的快递外包给丰程以后，差得一塌糊涂，不仅速度慢，下雨外包装烂完，以前从来没遇到过。快递人员负责程度也比不上自营的时候，简直想放弃亚马逊了	negative
调节出水的那个把手，拧了三次就坏了。懒得换了，对国产的东西无语了	negative
价格欺诈啊，当时看到是29元秒杀价的，结果还是按照原价来结算了，很让人失望！	negative
前几天年值货评选，找什么值得买举办，结果奖品都被他们小编贪污了；买个东西，找全峰快递送，只送到门卫，还骗你说联系不到你，只能放门卫了，每次都这样骗，一点技术含量都没有。 再这样下去，亚马逊只会越来越掉价，沦为三流电商。	positive
实物比图片尺寸偏大，使用舒服，又买了一件。	positive
盒子注明内有3个笔芯，但我只收到2个，联系客服说不退货的话补15元的券给我，但几天了还没收到	positive
看到了书，有些不满，好好一本书到我手里磕碰不成样了，不知是货品就这样还是快递不行	negative
包应该是真的，我看做工挺细致的，材料也不错。但为毛不给我发票，为了凑这个发票好麻烦的好不好！！！	positive
不错 内容充实 答案具体 适合练笔	negative
内容比较浅适合初学者，马爷的文笔功力还是很不错的，但书里的图片实在太让人失望了，本来就是看中有图片版才买的电子书，但图片的清晰度简直差得不能再差了，只能用模糊两个字形容。我很难想象实体书里图片要也是这个效果，实在太对不起读者了。醉文明4 里面的图片质量清晰度明显有了很大提高，有些图片在ipad上看能看到一些细节了，但说实在话依然图片还是有很大的提升空间。	negative
非常好的一套书，给孩子们上课用的，增加课外知识和阅读能力	positive
我是冲着《藏地密码》的水平去的，这本书令我大失所望，绝对的上当	negative
没有用，感觉还可以。说是有活动返代金券，可是我没有收到，不诚信。	positive
包装好，喝的来伯爵的话，味道也不错，但是感觉也没有比其他几款更好，但是泡完之后杯底的碎茶末少，真的特别少！喝过几款伯爵，这款茶末特别少，说明滤纸好吧，也许是贵的原因吧。	positive
内容还行，就是纸质太差了，摸起来太硬，毛糙	positive
拿下不久就会发热，眼睛热热的很舒服，价格比国内便宜，用完还可以做眼罩使用	positive
价格还是实惠的，但肠胃可能不怎么适应，喝几次就放 着了，应该是正品	positive
这是一个零零碎碎拼凑起来的合集，有70%的甲壳虫文案原文及翻译，让我以为没买到完整版…不要买，不要买，不要买	negative
东西没有包装好 货到的时候都流出来好些了	negative
为什么日本🇯🇵的小林怎么是中国生产？？？？？？	negative
狗狗喜欢，稍小了点，还是赞一个！！！！！！！！！！！！！！！	positive
考研用的。。不太喜欢这本。讲的太简单了。还是喜欢钱理群的	positive
首先，耳机很轻，并且支架很柔软，佩戴舒适。音质方面的话，低音沉，高音的话，张力不够，也就是高音低音部平衡。听歌的话，总感觉高音缺少了什么。	positive
也是醉了，说是签名本，根本没签名，换货一次，依然没签名，太没有责任心了。	negative
使用时会提示“非专业线缆，但调整后又消失”，比较放心了。	positive
目前感觉就是还没看内容，打开发现图片很不清楚，不免有些失望😞	negative
请好好检查此书的印刷，足足有十来页的空白！	negative
送人的东西，送到的时候书边都是瘪的，来不及换只好将就，以前也没有这种情况	negative
退货速度太慢，退货要像订货一样的效率，那就是真正的服务。麻烦退货手续快点，10多天了	negative
不错呀，朋友介绍过来的，今天已经使用一次，很细，早起很省时间，可以放心购买。	positive
还可以吧，有个大体的了解，感觉还是不够客观，但没依据只是感觉	positive
顶端的花是布做的，花瓣边缘很多瑕疵，和图片看上去差距太大，另外亚马逊选择的东方汇快递快得已经让我不想再在亚马逊购物了	negative
作者讨论的对象都很大，如理想、爱情、亲情，但却将复杂的问题简单化、多元的问题单一化、客观的问题主观化，而且逻辑和文字功力都堪忧	negative
清单用透明袋子帖盒子上，商品描述都看到了，说好的保密包装呢	negative
这个裤子质量特别特别特别特别差差差！就穿了3天，大年初一到初三，裤子上面就有十几个破洞。发不了图片啊？	negative
对快递非常不满意，店家怎么和快递沟通的？要我加钱，钱虽然不多，但上面说的可以送货上门或者自己提货，结果自己提货得加钱	negative
没有给五星是因为快递。酒水是倒着放在门卫室的，外面的包装盒都快散了。酒水的外封条开了一边。见图吧。	positive
东西品质一般，国内价格较贵，以前美亚能直邮，可惜现在不可以了	positive
除了好评没有其他，但是要吐槽物流，没有及时通知收件还篡改配送时间！！！！	positive
从其他网站看到介绍买的，内容看了有点失望。一般，不值得推荐。	negative
收到包装特别好，不过保修卡太容易被连着一起撕掉了……本身也不是很懂耳机啦，索尼大法好，不过带上听一段又换苹果耳机，马上效果就比出来了……这个价位还是很棒的！╮(￣▽￣)╭	positive
给一星都是多的，首先是物流，下订单三天后发货，又三天到货，快递员打电话家里没人，索性扔在门口就走。再说质量，粗糙至极，塞子根本拔不出来，更别说喝水了。在亚马逊购物体验最差的一次！	negative
买给我妈喝的，她说上面的生产日期用手一抹就掉了。。而且奶粉成坨，不容易化开。。	negative
还可以 里边配比的很丰富就是猫猫挑这吃剩下一些就不吃了	positive
世间万千人，多少人在你未知的角落里笑着哭着开心着悲伤着，知乎让我知道有更多人的人的生活可以比你精彩，比你平庸。。。。。。	positive
上午选当天送达，下午很快就到了，书本质量完好，服务很赞。	positive
亚马逊打包的太垃圾了，买了13桶奶粉居然就用一个纸箱子，直接装来了，没有任何包装，太不负责任了，快递刚送到，我说是奶粉我要检查下，快递员说我先接个电话，人就走了！结果还真有两桶是瘪的，自认倒霉！后面就不承认了，店大欺客的最好证明！	negative
走两月坏了 等待售后服务 别再这个网站买东西了 跟本就是流氓售后 这个牌子也是垃圾	negative
挺温和的，香气淡淡的，好闻。一大瓶，挺实惠。打算用完再买一瓶。	positive
这次购物不怎么愉快！明明点了40码的可卖家给我发43码的，根本没发穿，只好自己花20块发了快递过去换了，在老家农村嘛货到了还得花5块去拿。唉	negative
小时候很喜欢看 但是现在看突然觉得笑点非常无聊了	negative
纸质版下架，入了电子版。因为翻译用词粗俗而受到不少关注，但是它不符合我胃口，不是因为粗俗，而是缺乏美感。太过平淡的翻译，完全没有传递出英文原版的意境。	negative
怎么连个联系客服的地方都没有，快递已经4天了，还在中转，而且是从佛山发货，我开始怀疑货品的真伪了，太不靠谱了！	negative
将就吧，没有想象中精致，而且增厚不少。不过作为保护屏幕来说还是挺好的，出门的时候可以用用	negative
不是对产品抱怨，因为根本就没打开。手快的下了单，然后看了评论就后悔了，想立马取消订单，但是已经不行了，打了电话给亚马逊客服，说只能货到后再退货。一个129的东西，我退货发个快递都要4，50，真是无语了。这次的购买体验太差了，以后应该不会再来了，就当花钱买个教训吧。	negative
由于第一个烧了，买了同品牌另一款吹风机。希望能耐用些！	positive
前面写的很好，但是后面的问答让我不太喜欢	positive
非常好用 用完一只后 鼻子旁边的脸颊部位的毛孔明显变小了 搭配小白瓶一起用 白了很多 所以又回购一支	positive
本书毫无学术内容。被归类为心理学类图书，实属对真正心理学图书的不公。	negative
家里老人签收，收到时包装已被人为拆开，袖子超大	negative
衣服有点小，肩膀部位紧，建议买大一码。款式看着挺好，没有图片上亮。另外，手不太方便放到口袋里。还是挺满意的。	positive
送给男朋友的，他很希望，里面有很丰富的配图，让你读着很舒服	positive
里边纸张有好些地方是坏的，有严重缺损，特别差。	negative
差评 衣服上有口子 包装前不检查的么	negative
皮刮痕明显，应该人造皮革吧，背带很难看。不值这个价格，扣子第二天就坏了，快一周了给我寄了第二个。本来想让店家给个几块钱维修费我找个地方缝一下，也不愿意，不知道是怕我坑他几块钱还是咋的。	negative
对亚马逊挺信任的，想不到这次第一次给一星，虽然也是第三方卖家的，但是是终归也是属于亚马逊管理的。 茶叶基本没香味，味道也淡，还不是那种回香的那种淡，如果是这种品质，便宜也就算了，还卖得死贵。 非常不满意的一次购物	negative
拆包后发现寄来的鞋子跟订购的鞋子颜色完全不一样，已办理退货。	negative
太辣了这个糖，之前买过一次这牌子的铁盒装的，现在这个就是便携装吧	negative
正好我刚刚看完了电影《沉默的羔羊》，在搜相关影评的时候，发现了这本书，就买了回来。书要比电影好看，透露了很多案件的背景信息。还有FBI的探员们从现场痕迹来推断凶手个人特征、心理特点的方法也令人惊叹。	positive
3本书，愣是把我家的2kg的小手秤爆表了…… 出版社考虑用用轻型纸也好啊，平均将近600页的书拿着累不累啊。 趁活动入的，算起来70块，确实很合算。	positive
对于一本书，我们首先从形式上来说吧：整本书一半是大大的标题做的插图，一般是粗浅的随笔。 其次，从内容上说，全部是作者自己的经历的感悟，只能说一家之言，并且逻辑丝毫不严谨不科学。 虽然写的挺实在的，毕竟你在实话实说，但我想说：如果这都能出书的话，那么人人都能出书！！！！！ 可恶！！！！	negative
以前买过一样双面的要九十多，另一面垫下面都长霉了，一面足够，这个经济实惠！！买回来折痕比较严重，坐两天就好了	positive
觉得很不错，对得起这个价格，虽然是中国产的	positive
另一本书的推荐。彩色的。看着很活泼。愿意不停的看下去。	negative
音质很好，体积很大，很重，拿着不是很方便，但是用起来还是很好的，音质很好，使用方便	negative
8月底买的715，到了10月份就变成689，一样的M码。太过份了。	positive
还不错，主要是价格便宜116买下，运费20没关税	positive
罗技的维修服务，真是用户体验最差维修体验。耳机开机后一分钟内会自动关机。打电话找官方客服，提出愿意付费维修，哪怕是最简单检测，如果坏了可以重新买。但客服表示，只接受京东和天猫购买维修，亚马逊购买的不管。我提出产品不是海外购，应该是国内行货，对方时表示，由于耳机没有序列号，只认发票不认机器。并表示，亚马逊不会提供发票，所以他们在国内不管。罗技是我在全世界各个国家遇到最差客服体验。非常糟糕	negative
我买的是新书呀，发了一本旧书，中间都快脱出来了。对亚马逊很失望。	negative
印刷的不行，也没什么有意义的建议，字体比普通书大几倍！！！	negative
印刷，装帧都不错。 故事就是日本典型的那种带着淡淡的忧伤，又有着对‘生命’这类主题的探寻的意味。	positive
还行，有点偏厚，再薄一点就更好了，还有为毛那么重？	positive
功能还不错，可惜好马没配好鞍，用了两个月支架断了，不能配好一点的支架吗？支架副厂生产的？	negative
书页薄，书内有两页损毁。一页缺少九分之一，一页缺少三分之一。	negative
剪开大米包装后，从里面爬出一个小黑虫，说明了商品存在质量问题。	negative
刚过返修期2天就漏气了，已经不能用了。进气口上面的胶开了。	negative
本来以为送了下水就不用再买了，没想到最下面是个硬管，根本没法正对着下水道。问客服说让自己去淘宝买一个软管来解决。那我要你这下水干嘛呢？唉，还没安装上就一肚子气。	negative
真的水土不服，我不是基督徒，对圣经也没多少兴趣，所以很多圣经故事只知道最广为流传的，其他真不清楚。这本书我想是从诺亚方舟开始顺着讲的，可是真心觉得无聊，不知道原文是否这么枯燥，我想这就提现翻译者的文笔了吧。也就开头我看了十来页，大致明白是对于诺亚方舟上生存下来的物种的一种嘲讽，后面实在看不下去了，如此干巴巴的，实在没有坚持下去。 不管推荐说的如何好，国外如何溢美之词，只有对自己胃口才是为好书，对自己有帮助的书。诸君若有更好版本的推荐，请不吝告知。	negative
快递慢，书都坏了！！！ 太影响心情了，要不是急着要看，就退货了	negative
我买的时候正好降价，特别划算，穿起来很舒适，以后即使没有降价也会买的	positive
怎么说呢万斯就是穿个样式要说质量还真不如匡威，脚感也比匡威帆布鞋差。万斯的做工很粗糙只是外观漂亮好配衣服其他没什么亮点了	positive
引领时代潮流，以独特的思维介绍了互联网思维，概念清晰，值得一看	positive
呸呸呸，刚买来貌似不漏，这次拿出来用，从出气孔里往外漏水！另外，盖子已经松动了。跟评论里宝妈们说的一样。设计缺陷吧！考虑要不要换里面的吸管配件，拯救一下。	negative
正品。颜色非常好看，不会看腻的那种。钢笔写字基本不会洇，不过到底洇不洇还要看你的墨水和笔头出水量。纸张很顺滑，米白色看得很舒服。极简风很合心意。	positive
该商品已有55人评论茨威格集:一颗心的沦亡（世界名著名译文库）	positive
由圆通发货，并没有收到，给我弄丢了，圆通已赔付	negative
书还没到 但是一定要给快递点个赞 因为自己留错联系方式 快递找不到我本人 在家门口收到了字条 很感动 真的是非常负责 大赞一个	positive
严重怀疑是不是翻修机器，首先电脑运行非常慢，我用了好久才来评论，那天忽然间一个螺丝掉了，我真是很郁闷，以后要买就到官网买，真是便宜没好货	negative
钻毛，不好。四件套也不好，掉毛还起球。不值得购买。	negative
民国时代的女作家,了解哪段历史,值得拜读.	positive
物流太慢，太慢 太慢，确实太慢了，比京东慢太多了	negative
很好用啊，这是第二个了，不能再被偷了，，，	positive
还没看完。以前从不去评价，不知道浪费了多少积分，现在知道积分可以换钱，就要好好评价了，后来我就把这段话复制走了，既能赚积分，还省事，走到哪复制到哪，直接发出就可以了，推荐给大家！！	negative
多年的高层矛盾，国际形势的恶劣，加上错误的判断，最终导致不该发生的事爆发了！！！	positive
相比于电磁炉，电陶炉不挑锅，但是散热慢，浪费电，家里用电磁炉没问题，用电陶炉的时候，插板那里有杂音，感觉要爆的节奏，已经收起来了，不敢用了	positive
鞋是正品就是有点小 平常篮球鞋 44码刚好 这个要 44.5能穿 但是很紧	positive
制氧机挺重，工作声音不大，操作方便，好用。	positive
书有质感，质量不错，女娃的最爱金粉，娃儿总是说太漂亮了，但看的频率并不是高	positive
在Amazon退货本来都很便捷，可这次，19号提交申请，明明写的是会来取退货件，直到30号都没任何反应，我这天天看进度，准备迎接快递，糟心啊！于是打电话给Amazon客服咨询。 3、更奇葩的来了，客服说了一堆理由规定，说要我自己寄。我认为我已在网上成功申请退货且由商家自取也是你们退货时认可的，现在不但操作不及时还要自作主张修改流程。不管问题是商家还是Amazon自身的，我都无法认可。 4、向来很少评论，只有特别棒的和特别差的才说几句，请自处。 1月11日追加评论 5、亚马逊客服是没有阅读功能的机器人吗？！ 6、想看看到底这事儿会拖到什么时候？！ 1月16日更新 等了几天没啥进展，1月13日致电亚马逊客服，那位先生在听了我的陈述，看了我的评论后，承认了亚马逊的错误，并说明是拍货品的照片，我想既然承认了错误，也就算了。于是拍了照片发给了商户。 谁知，此去石沉大海，至今没有任何反馈，连那个客服机器人都不见了踪影。罢了，这退款亚马逊你自己留着吧！！！ 另外，为什么说到亚马逊的问题的评论总是第一次审批通不过呢，欲盖弥彰吧 1月24日更新 自13日与亚马逊客服联系后，至今未收到亚马逊和商家的任何反馈，彻底失望，可以卸载了。 2月2日更新 向12315投诉后，终于亚马逊客服来电了，基本上是承认错误，承诺内部处理，坚决不清退账户余额，我也是无语了。更奇葩的是，我说，这货的退款，亚马逊爱退不退，赶紧清退我账户余额，不想再跟亚马逊有半毛钱关系。这个奇葩客服这话倒是听进去了，迅速把我的退货订单取消了。亚马逊，你还要脸不要了？！	negative
好书，画皮之道。广告界和绘画艺术界的蒲松龄，扒了皮给世人看。	positive
不好 刚拿到的时候觉得颜色还不错 但是套上去之后就发现不对了 背后很多彩色的指纹印（不是在外面 是在里面）于是我就用湿纸巾、眼镜布擦啊擦啊 结果贴上去 又有了。。 这个膜 建议有强迫症的人不要用（我就是）	negative
收到两个 居然都坏了 联系卖家 好几天了也没回复 以后在亚马逊买生鲜要慎重	negative
尽讲些常规的方法，只能说适合时间管理的初学者。	negative
质量差，用了两年面料爆裂，有弹力的地方全松散了..等等，材料质量超差	negative
这个产品似乎质量有问题，刚用两个月就接触不良，充不上电	negative
很差的体验，很难粘在一起，而且掉在地上很容易卷上各种头发，纤维，拿不下来，而且娃有时还喜欢放嘴里。适合大孩子吧，家里很干净。	negative
箱子很漂亮，不过还没用，不知道结实不结实	negative
还行，容量挺大的，就是给充电宝充电有点慢，不知道为什么。	positive
给老人买的，主要用来打电话，偶尔照相，玩个游戏。总体来说不错，有过一次打不通的情况（信号消失），在原地重启后恢复。这个价位的机器，如果是买给老人的，推荐这款，大品牌的品质还是有保证的。	positive
非常好用的工具书，拿来系统学习语法也是很好的选择，笔者行文很像老师在教课	positive
音质还行，但充电后第二天就开不了机，蓄电池严重问题…有朋友知道怎么投诉亚马逊，耳机充电后放置一天就开不了机，商家无反应？？？	negative
开声地摊音质，煲开也不好听，还没有苹果小白兔音质好，佩戴一般，打球带紧后耳朵会涨，连接真是灾难，在公共场合无限断连，卡顿，感觉只是个半成品，以后对jbl耳机说再见了，买了ie80s了，jbl的音响还在路上，希望不要变成jbl黑粉	negative
物有所值。超级好玩。孩子只有一岁半，很喜欢拿着大鲸鱼到处咬咬	positive
整体的装订印刷质量都相当不错！是我见过截至目前出版的所有纳尼亚版本最好的！推荐购买！要说美中不足，就是价格还是稍贵了点！	positive
物流速度很快 不到一周时间就收到了 包和图片上基本一样 很实用 也挺能装的 就是线头比较多 包身正面有点歪 可能是运输过程中压的我希望撑撑可以恢复	positive
怎么说呢，就是这个皮带的做工总体还是符合这个价位的，但也不要想的多好，一分钱一分货！别人评论里的小瑕疵、简包装都是事实，感觉评论的都很中肯！皮质还是有些质感质感的，我这一条Italy产，本人2尺4的腰围，买的85差不多刚好	positive
5月29号到6月6号，9天时间，今天7月7了，还在运输途中，真是溜得不行	negative
之前用的是送衣服的钱包，不过比较接地气，有透明的口袋放身份证刚好。这钱包就不行了，毕竟老外不需要身份证。 我放了6张卡和20张纸钞就有点合不拢了，零钱包用处一般。	positive
买电子书，连电子发票都不提供。打电话，说可以邮寄纸质发票。只能挂号寄，半个月能收到。但是如果寄快件，邮资要客户承担。	negative
收到货，打开看男装不新，为什么又过小不知道发货时发错没有。	negative
尼德合作的快递好坑，我花了十多天才收到。。。椅子还不错，没有让我失望。	positive
上一次在官网上找的天猫官方旗舰店买的试用，喝起来比这个味道浓，这个很淡，不过查验证码是真的，但感觉不是那么真	negative
乍一看加州，还以为进口呢，结果是已经变质的国货！ 打开一吃，哈喇味很重，已经变质了！ 看好多人评论说已经变质了，我没太在意，心说我能那么倒霉吗？结果真是不行啊！买来了就是哈喇了，不能吃了！10块钱的东西，也已经开口吃了一个了，也懒得找客服换货了！这次购物体验非常不好！非常不满意！	negative
儿子好动,对这些东西都比较好奇,他爱看我也宽心,很棒的一本书	positive
看书还是不能看头衔看包装，实话说买的便宜又精致的小绘本内容上更有趣更有想象力。	negative
之前还担心容量太小，到手了用了下，放在包里刚刚合适。保温效果也很赞。	positive
这套书读来非常有趣味和涨知识。以前在微信听书中听了一段时间，决心买套文字版的细细品味。	positive
今天收到了货，明明是要带在右边的，发过来却是左边的；而且包装明显有人动过的痕迹，打开一开，没有数据线，没有说明书，里面的包装很邋遢，耳机明显有人动过的痕迹....我彻底的无语了 打电话给老板留在亚马逊上面的电话，根本就打不通，这种服务让人崩溃....	negative
身高186cm 体重95kg xl码感觉太肥了 长短还可以 肩部宽 胸围肥 估计穿l码就够用了 质量还可以 对得起300元3件这个价格了 退货太麻烦了 当家居服穿吧 版型不是修身的 有穿老头衫的感觉	positive
先不说质量如何，就是快递就让人想把货给扔了，就变更先收货地址，相差几百米，结果麻烦一番还不说，妈的，还来句爱签不签，什么时候碰到过这样的快递；给亚马逊反馈，商家也没反应。	negative
送货一贯准时，咖啡我是LAVAZZA的老买家，亚马逊OK。	negative
东西挺好的，就是不耐摔！宝宝坐在幼儿餐桌椅子上摔了几次就破了……破了……破了一条大缝！从碗缘到碗底……	negative
因为来自于演讲稿，其中内容相对驳杂无序。部分例子过于贴近生活有失严谨。和严谨的著作相比差距还是很大的。不过还是不错的杂文吧，有空读一读还是不错的。	positive
三本书有两本拿到书外包装膜已经被撕掉，脏兮兮的	negative
个人觉得很好看，我买的kindle电子书版，几乎是一口气看完的，内容很精彩，也很值得人去深思	positive
内页油墨轻重不一，看起来很费劲，没想到人民文学出版社印刷质量如此。	negative
评论区有些傻逼趁早滚远点，这款霜很多人说好用也有很多人说搓泥，因为搓泥就质疑海外购的东西是假货，你妈妈生你的时候是不是没给你生脑子？赶紧滚回你的大淘宝用你不搓泥的假货！还要你来充会员？？？	positive
收到货无安装螺丝及安装工具，靠背立柱明显出厂前就磕碰，客户电话无人接听，等待处理中 ------------------------------ 后来联系上客服，售后很nice，从其他库房调了配套螺丝发过来，安装过程再次悲剧，其中一条腿的内置螺母竟然没有，装不上，再次联系客服，等待处理中	negative
对于想了解社会人性的读者很有帮助，避免自己上当受骗，少走不少弯路，喜欢看刘墉的处世作品。	positive
你好 为什么我扫此款只需要378你们居然还标价990 在来一个打折443卖给买家 对不起我要退货	negative
速度慢的要命，大半夜的送到谁还能在单位等着啊。送不到就不要说今天送达。	negative
有很多实用技巧 例如简单绘画和排版 语言生动 很吸引人	positive
号码偏大，平时穿S，这款买了XS正好。绣花漂亮，颜色也正。据说色牢度不行，但是还没洗过，这价钱可以接受。	positive
收到物品包装和做工很不错，但是安装后前后摄像头清晰度真心不行。前置摄像头就白天连前方车辆的号牌都拍不清楚。后方的那个更不能形容清晰度了，只能雾里看花了。	negative
周五买的，今天发现就降价120了。如何实行价格保护？找了半天也找不到亚马逊上如何申请。 如果不退钱，就考虑退货了	negative
完全不值得买，全文玛丽苏，几乎所有的伏笔都一眼看穿，男女主各种刻意的误会，文笔也很弱。买了这本书不仅是对钱的浪费，也是对时间的浪费。	negative
唉，序言还没看完，可是真的是译的很糟心，虽然看了前几位的评论，但因为需要了解文化史，所以还是硬着头皮买了，有点看着郁闷	negative
产品质量还是有保证的，起码和香港一样保修一年。不过同时存在以往买家所说的存在按键松动问题。希望能耐用。重点！建议亚马逊（香港）更换快递公司吧，垃圾圆通，在没有通知本人收取快递的情况下竟然谎称本人已签收，什么情况？！打电话给亚马逊反映情况后，亚马逊帮忙追踪，快递员才送过来，那快递包装质量真心差！快递员还语气很差质问是不是我打电话说没有收到快递...真心希望亚马逊不要再和这种快递公司合作了，唉...	positive
佩戴时间长了 耳道难受 配对完成后左耳无声音	negative
今天收到，这产品不错，跟图片一样，无色差，质量还行	positive
试了一下，很合脚。也很漂亮，就是感觉质量不太好，要穿了之后才知道	positive
178cm 75kg M略修身 但是logo是灰色的并不是图片上的白色 遗憾	positive
2013年买的书，当时看有防伪标识以为是正品！2013年忙没顾上看，最近要考试重新看，发现错误连篇！再一看防伪标示！加热变色是吧？？？我特么打火机都快把书烧了！也没见变色！真特么服了！我这已经是第二次在亚马逊买到盗版书了！亚马逊不倒特么的真没道理了！	negative
完全是西方人的视角，有偏见！部分文字甚至有对领袖的诋毁！	negative
性价比还蛮高的，是我想要的那种全透明，软软的、连带防尘塞的外套。比之前在店里看到的什么398、428使用便宜得多得多	positive
非常好，手机充电好用，蓝牙听歌好用，蓝牙电话接听 好用，就是不知道蓝牙回拨电话咋用？	positive
不满意，要求上传身份证，上传后十天了，还没收到货，客服说7-10天，这已经11天了，骗子吧，不会再来了	negative
商家当天就发货并且第二天就送达； 产品和描述的一样可靠，很强的吸水防潮性，特别那几天下雨，非常有用	positive
老公生日礼物，用着行，就手机屏幕为什么黄？	positive
还不能说最详尽，而且内容也不多，没有看到想要做的甜点	negative
原以为在亚马逊买书买的是一个放心。可惜让人失望了，56块钱的书出现了两页页面缺损。亚马逊的产品质量也是令人担忧，盛名之下，其实难副。	negative
仅仅只是一个个的故事，除了末尾的几篇基金定投的经验，其他的。。。也就那样吧，不推荐购买	negative
奶味是要重些喃 只是到手时离保质期只有两个月了	positive
够大、给妈妈买的、包包本身一些分量、有些重、不过整体还是不错的	positive
宝贝到手后外观是和图片一样，本以为里面全是棕色布料，结果只有帽子里面是棕色的，左边口袋里面破了，自己缝好了，肘部不是皮革而是棕色布料。	positive
生不能平等，死后却可以。作者用荒诞的笔触抨击了这个荒诞的世界，读完让人甚感悲凉。	positive
很舒服，尺码偏大一些，但还好，价格嘛，比国内便宜很多，一个星期就收到货了，亚马逊海外购越来越给力了！	positive
鞋子做工较好，希望以后能有实拍图，而不是官网图片	positive
穿着很舒服价钱也便宜，美中不足才买就降价了	positive
书的内容相对比较新，翻译的也不错。排版很好看，图是彩的，很漂亮	positive
如果选择水压大的话，前面喷出来的水还热的，后来喷出来的水就变凉了，估计出水加热的功率小了点吧。	positive
14年10月份买的，2年半多点时间，今天早上泡茶，喝这发现往下滴水，才发现裂了缝。 一紫砂杯和几块钱的玻璃杯一个效果，无语。 一直首选亚马逊购物，这几年感叹电商难道是专供？ 以后还是不能怕麻烦，选实体店吧。	negative
本来怕在京东买到假货，来了亚马逊，结果发现都是一丘之貉。垃圾。 还号称德国工艺！怎么不害臊的！！ 樱桃的logo地方做工都不咋地，背后的贴纸就像是地摊货！印刷都不清晰。 懒得退货了，后面想买的人，看看评论吧。	negative
用了一个多月，每个星期都快4-5分钟，售后也很不到位，谁买谁上当	negative
封面不一致，尽管我喜欢收到版本的封面，但还是不能赞同这种不认真负责的态度	negative
给发的是拆了塑封的，封皮那叫一个脏，一同购买的好几本书不是边角磕坏，就是封皮脏。我是懒得换货从来不退换货给我发什么我都认，要是足够龟毛，我他妈换货一百次。	negative
为什么我开了一次静音模式，然后手机干什么都没有声音了。还吱吱的响。	negative
昨天下单今天到了，速度挺快，但是内容一般般，而且排版都有错误，第23页竟然跨行错误。那到手上书角上下都是坏的。失望透顶。	negative
中国制造的 鞋带很劣质 鞋底没那么软 建议去实体店	negative
试用了一下，按比例和面，压出的面有点黏。另外，清洁时有点麻烦费时，有点买的后悔。怎么办	positive
和我想得不太一样，但是也很不错了，里面还有一些插图，非常喜欢这本书以及它的电影	positive
一直在亚马逊海外购上买Clark的鞋，非常舒适，这次到货也很及时，赞一个	negative
漫长的亚马逊物流22日拍的29日还没有收到！熬心呀！	negative
垃圾快递，放门房一天后通知我。东西都坏了。看来网购生鲜不是件好事情。	negative
期刊读物，一直在订，亚马逊的价格比较实惠	positive
买卡诗的赠品 打开包装后味道很大 如其他评论所述 涂抹梳齿圆头的材料还有细丝粘连在一起 品质看起来很一般	negative
有些书 名字起的吓人， 內容很粗糙， 差太远了	negative
用了半年耳机一只没声音了。请问有售后保障吗	negative
喜欢这个味道，洗完了滑滑的，以后有机会肯定还会再买。	positive
金属边框很漂亮，系统很给力，不卡机，总的来说，优点特别多，缺点就是：充电时手机严重发热、手机在连续使用下电池极度不耐用(4,5小时就没了）！如果续航再给力些，这手机堪称完美！	positive
商品不说，配送人员态度极差！！！买了一肚子火！！态度太撇！！！简直素质有问题！！包装也烂！！简直是虐待我的书！！有这样的人配送以后绝不来买！！！	negative
买的致命玩笑30周年珍藏版包装简陋，破损严重，所以这个也不想给好评。既然是珍藏版当然是用来珍藏的啊，给我好好的包装啊混蛋，就一层塑料袋是几个意思？指望快递员都是两学一做的践行者嘛？	negative
这本书是我的如本书 一点点的都看完了 不过内容都是很基础的 要实用的话 还要自己多去练习 但是拿来做入门书是很不错的 质量很不错	positive
可能今天看来有些文章写的有点简略，但有些文章还是可以一看	positive
早前购买的为了老树的插图，内容不是现在大多数人喜欢看的。	positive
还可以，就是设计的不是很合理，没有新安怡的好用。	positive
质量很好，也很漂亮，哈哈，不错，鞋码也很正，喜欢	positive
这东西整天秒杀的？昨天前天大前天都秒杀啊。这还叫秒杀吗？直接叫年杀就好了。 另外，现在标注“直接amazon销售和发货”不可信，亚马逊信誉真的越来越差了。明明是“直接amazon销售和发货”，居然是厂家发送的。 而且评论页面也是厂家直接管理的，我这评论基本不会被厂家通过、显示。	positive
收到了，非常给力，质量及做工都很好，这款的材质不错，保护套颜色很漂亮，套上刚好 和店家描述的一样。挺满意	positive
是我喜欢的牌子,但是吊牌没有跟衣服连在一起,可能是别人试过了的,所以只给了4个星.	positive
第二本大鹏的书，觉得还不错，就是不喜欢快递，显示已经签收，我没收到。快递没电话和信息通知，要我联系卖家才知道书到了大堂	positive
图书刚开始都是讲安装之类的图解，用处不大。感觉概念太多了，实用性不强。	negative
换掉电池之后，手机充电的时候打不开，一直过一下震动一下。开机时开机不了了！请问卖家应该怎么办？	negative
质量不错，就是贵了点，有两个配件稍微松了点，容易掉，4岁宝宝玩正好。	positive
OKR的逻辑可以清晰知道，问题最大的是团队如何对OKR达成一致，能否发挥大家的主观能动性，能够主动设定更高的目标；同时，如何能够让薪酬跟OKR不挂钩。我达成了一个关键结果，不给薪酬奖励？？ 实施面可能还会有些问题。	positive
质量太差 用了一年就坏了 拿这套东西在维修，他们判断东西的好坏实在太原始，直接通电，看是否正常，结果换了电动牙刷杆，充电器也有问题，害了我跑了多躺，难道飞利浦维修点连一个万用表也赔不起吗？！	negative
一点哲学的内涵都没有~ 对不起这个标题 ，失望！！！！	negative
2月3日买了三罐，228一罐，现在169一罐，这奶粉到底是真是假？	negative
商品不错，快递师傅真心差评，在楼下大喊大叫，也就算了，让让他直接放窗口，下面的平台，可以让他省时间，同时我在下楼。到楼下时，发现书扔在地上，问他为什么丢地上，不是有平台嘛，突然张口很凶的对着我喊，你什么态度？到底谁什么态度了？真心奇怪。	positive
不谈内容，给我一本旧书是什么意思，各种划痕，不能忍。	negative
书不错，已经看了一遍，虽然书名说是互联网思维，其实还有让你知道怎样去为自己工作，不过里面有很多的关于国外一些app应用的提及，我没用过，也没有可以使用的真实环境，不知是否真的好。不过我没有从本书中得到互联网思维的一些新奇的耳目一新的创意，本书比较深入的介绍了不在公司办公，不定时工作，自由职业者等的一些特征、想法。	positive
怀疑是假货因为根本就没有国行好用，大家别买	negative
亚马逊发货的，但是不是正版，和以前买的新东方的书完全没办法比，纸薄发黄味道特别大，绝对不可能是正版。没想到亚马逊发货，花了正版的钱买了质量极差的盗版，以后不会在亚马逊上买任何东西了	negative
挺喜欢这种简洁风格的桌子，上下都是书架，能放很多东西，靠墙会稳固一些	positive
买了英语5和7，肯定是盗版，因为印刷质量实在是太差，字体不清楚不说，5的有些纸张居然是连在一起没有裁开的，有些的字高低不一歪歪扭扭的，怎么看着像手写的。。。已经不是第一次对亚马逊失望了。	negative
想换个屏幕大些的手机，正好看到促销活动选择的，性能比想像中要好，反应速度感觉比正在用iPhone还快，屏幕最满意了，使用了几天没有发现网上说的WiFi网络问题，电池正常使用待机一天左右吧！系统优化非常好，流畅啊！.说点缺点:音量和电源键松，晃动有响声，触动感没有苹果手机好，电话卡弹出架焊接点不牢固，真怕那天换卡时损坏，希望下代产品改善，价格可能决定产品质量。	positive
非常美味，对于狗狗来说。闻起来很香。质量超好。	positive
等了比较久，书店客服说没书了，退款给我，早知道买其他家的了，耽误时间。	negative
比较适合初级入门的同学学习。 第一篇讲授基本原理，第二篇讲授具体合同应用。 是面向工程合同实际应用管理能力培养的好教材。	positive
挺好的，线也足够长，比较小巧，需注意电压电流是否匹配	positive
包装简陋，东西还行偏小。（以前从不去评价，不知道浪费了多少积分，现在知道积分可以换钱，就要好好评价了，后来我就把这段话复制走了，既能赚积分，还省事，走到哪复制到哪，最重要的是，不用认真的评论了，不用想还差多少字，直接发出就可以了，推荐给大家！！）	positive
卖家发错货了，给我发了一个便宜的类似手表，信任亚马逊所以我没打开验货就签收了，我不知道这种商品居然不能退换货！很生气，最后没办法联系客服给我补了21的优惠卷，但是心里还是不舒服，毕竟不是我买的那款，四百多的东西最后因为卖家发错货我只能自己打碎牙齿自己咽	negative
老板，书很好 为什么我要求发票 却没给发发票呢	positive
图大小了，不清晰。导致每页都要放大，太影响效率了，眼累，心累，手更累。读书投入最大的是时间，这等于让读者浪费太多时间在一些无谓的操作上，太愚蠢了。	negative
用了快两年了，名不虚传，天天背。拉链头漆有些磨损，面料里料背带和新的一样。	positive
按照亚马逊智能推荐的尺码买的，过大，还不管退，有本事别推荐尺码。	negative
错别字 真的很多 很多 多 ....... 上传一处 你们随意感受一下	negative
买下这个锅已经一个多月了，收到时翻遍了所有的包装，也没看到锅盖把手，向卖家反映了无数次，开始叫我拍照片，把照片发过去后经过几次交涉，说会补发。过了半个月没收到，再次催问，说已经发了要催快递，又过了半个月，再问，又让我发照片！一个没有锅盖把手的锅根本没法用，一直扔在一边。只想问问卖家，没发就没发，为何要欺骗顾客？是舍不得几块钱的快递费而不肯寄，还是以为所有的顾客都可以忍受这样的忽悠？这样的服务如何赢取顾客？你们只用一个本应配齐的配件钱失去了一个顾客的心。	negative
还可以吧，刚到，还没细看，不过书的装订质量不是很好，封面上还有胶水。	positive
我用此锅做饼、做锅贴，很好用，受热均匀。炒菜没用过不知道效果。	positive
人物很丰满，很令人倾佩，但我觉得作者没有更详细的叙述，一年一章太过于潦草了	positive
看着觉得很不错，，希望会有用，，会坚持看看！！！需要的人赶紧入手哟	positive
第一次在亚马逊上买书就出现问题，明明拍的是上册＋下册，结果只发上册，付款和沟通也很麻烦，以后不会在亚马逊上买东西了，太麻烦还出问题。	negative
收到第一次买的裤子，只能说 他妈的，真心不错，以后就亚马逊了	positive
第一次在亚马逊买东西，就买到了洋垃圾，真是像其他买家说的一样，穿了一回，竟然开线了	negative
第二天就收到货了，速度快！内衣质量很好，手感不错，推荐。	positive
好像买了这套书跟直接去官网注册一个帐号没什么区别，反正看视频都是要钱的。 有一本书被弄坏了	negative
物流跟蜗牛一样慢，等得黄花菜都凉了，退货算了。	negative
这本书差了第七章内容没有，少了30多页，太不负责人了，打了出版社几次电话没人接听，换都换不了，请大家慎重购买！从90页直接到了123页。	negative
亚马逊的快递，如风达服务真好，一个电话都没有，说联系不到。还有什么超出运范围？人家都送京东，淘宝都能送到，你送不到？如此大的网购平台物流如此之差也是令人叹为观止。	negative
不知道是不是因为是第三方发货的，书寄到后背面有一道划痕，封面有一些斑点，不过不影响阅读。	positive
第一次在亚马逊购买书，准时收到，质量可靠，下次还继续买。	positive
疑似被之前打开过的书（二手书），没有塑料封装，并且有一页是坏的，我有点不舒服!	negative
水货杯子，原标签没清理干净，仿标签也没有贴好。	negative
挺抽象的，但为了考药师，只得静心好好地看看。	positive
保持了亲王一贯的风格 问题是：爱情线完全没有了！！！	positive
耳机的效果很好音质很满意，唯一不足的地方就是不能通过耳机来调节音量的高低，不过这个价钱买到这种品质的耳机也值了。	positive
无话可说、第一次在这上面买、包装真的惨不忍睹、担心一起买的另一个、还有后台是不让上传照片嘛？？？？一张照片需要这么久？？？？	negative
包装很不错，质量也很好，要是长宽再加长一些就更好了	negative
纯粹因为好看才买的，只是因为太可爱了，好不好用已经不重要了	positive
经过师傅认定这家店里的龙头是假货进口进口是6分国内是4分这货就是4分	negative
垃圾，下个软件根本就扫不出来图，就这两本书也敢买这么贵，骗子。	negative
说是天蓝 其实比图片上深很多 是我个人不太喜欢的颜色。但是这个价钱买到天堂伞 我是觉得值了。	positive
其他两本很好 遇见心想事成的自己这本跟其他两本大小不一样 纸质也没有其他两本好 最恶心的是竟然有干了的水渍 还皱皱巴巴的！	negative
作为一个语言专业的学生，看这本书简直就是折磨。首先不能太理解科幻在哪里。因为每一篇都只是平铺直叙，很平淡的语言；可能是有深层寓意而我不能看到吧。其次，这是外国文学，翻译过后的科幻小说，不知道是不是很多科幻的梗都在转化成中文的过程中消失了。反正对于我来说确实是没发现什么精彩的地方。 这本书看了三分之一就果断弃掉。	negative
收到后，打开外面塑料包装，拧开盖子，没有锡纸或其他密封，发霉的味道很大，怀疑是退回的商品又出售	negative
很好的底本，印刷的可以，就是油墨太差，很呛人。可恶的印刷厂	negative
鱼还不错，冻得有点化了，不过没有糙。油炸后挺好的	positive
音质还可以吧，质量就不咋地了，买来还没用多久就坏了一个耳塞	negative
包装完整，其中一本包装轻微破损，书本无破损，卖家服务态度好	positive
很帅气的棒球帽，送给小男友的，他很开心，上班的时候都戴着不摘下来，哈哈哈，非常帅气，废柴小哥jh！	positive
虽然一包量不大~但是能吃很久~因为超级容易腻味啊~！	negative
喜欢，闺女很喜欢，就是移动时间有点短需要反复再按	positive
tmd…骗子，什么鸟真皮，才穿出去一个小时，就皱成这个鸟样。将近两百块钱，艹尼玛…奸商。	negative
送人的书，你们给我发个心经，你让我如何是好？我这会是退货也不是，只能硬着头皮不吭声。麻烦你们上点心。	negative
电水壶质量不错，不锈钢内胆，烧水无异味，满意	positive
书很好哦，对小小麦田有了更深一步的了解，快递非常给力！	positive
故事很一般，没有什么高潮起伏的感觉，人物角色不够深刻	negative
收到的笔，笔身有划痕，从笔头处一直到跟笔杆接缝处，长约3.5厘米。虽然不影响使用，但是总让人心情不好。看在笔确实是好笔，书写非常顺滑，沾墨书写也不断墨的情况下，我也懒得换了。不得不有个疑问，快递的包装完整无损坏，里面也没挤压受损的痕迹，难道是各地返厂的货再销售？	negative
这个牌子的玩具买了好几样 总体感受：很方便，设计很巧妙	positive
我精心挑选了很久的机器，很快就收到了，亚马逊物流配送速度特别快，服务也特别好。我立即把机器拿出来试做美食，我做了一个红豆豆浆，我先用锅子把红豆煮熟，然后再加上热开水，放到机器里面打红豆豆浆，打出来的红豆豆浆，完全无渣，非常细腻，口感特别好。而且商家的客服特别热情哦，买的这款机器，真的好极了。	positive
一开始看看还行，觉得自己是应该采取措施改变一下以往的充电方式，对采用的工具也应该有所调整，但是后面的内容基本上就是泛泛而谈，没什么可操作性。	negative
一直相信亚马逊自营的产品！这次竟然买到了假货！里面全是硬硬的小颗粒！我老婆用了脸上过敏都是红痘痘！联系了亚马逊在线客服！让我拍照片！我拍了发给他们！没了音信！我打电话给客服说元旦休息！休息过后给我答复！这都很多天了！一只了无音信！垃圾！亚马逊越来越垃圾了！	negative
没有封皮。一层灰，质量还可以，没有破损，习惯好评	positive
书是喜欢类型！这次价格给力！亚马逊现在免运费的要求越来越高了，看了公司有情况了？包装一般般，还好这次送到时书和包装基本没什么损坏。	positive
2/24日拍的货，到目前为止3/8日没有收到货！信息不及时更新，还一直停留在2/28日信息，已经3/8日了！信息说3/6日晚20：00之前送货完成，可怎么没有收到货，请给出一个合理的解释，这次购物，糟心透了！	negative
灯很简单大方，安装方便，底座稳定，还可以夹在桌子或者床边，非常灵活，配送也是一如既往的好	positive
看起来和历史教科书没有什么区别。还不如看历史书来着，起码还有点插图……也是难为作者了，码了这么多字，真不不容易。	negative
质量太差，穿了一天洗了一次就全变形了，领口都快成低胸衫!	negative
非常短的3篇短文，称不上是一本书。简单来说就是不需要详细的分类，只需要使用云计算服务（电子邮箱和云服务加上搜索引擎）就可以了。比较失望，原本是想get一些如何结合互联网和应用程序来实现个人知识库的技能，但这本书不是，并且理念也没有什么可借鉴的。	negative
比较全面辅食的一本书，确实花不了多长时间去做，而且纸质不错	positive
东西非常漂亮，保温效果好，一如既往的喜欢	positive
里面有很多故事，作文比较少，不属于单纯的作文书	positive
文笔应该不算非常差,但没什么特色。 疑心这类书很多,估计写起来有一定套路,虽然我不怎么看,实在不觉得能说好。 如果真喜欢哪一个,我会单独找写她的书来看,最好是她自己的文字，或身边人的评述。一本书写一箩筐，一小篇写一个人一生,毕竟粗浅。且是后世之谈。 如果没有 治愈你 那些东西,可能打三星。	negative
红灯一直闪烁，打亚马逊客服表示，海外购商品自己联系品牌方……OK，明年不用买prime了。亚马逊在中国被淘宝京东吊打是有道理的啊	negative
我的书直到现在都还没有收到！怎么评！一起买的书，其他三本早就到了，你到现在还没到，而且还默认收到，坑谁呢！	negative
送货速度特别快，配送员服务态度很好，建议给予此名配送员一定的奖励	positive
纯文字黑白版，没插图。小孩没兴趣看。还以为有插图。	negative
假货，读取慢，同样的文件，用其他牌子的一下读取出来，这个根本出不来	negative
本以为耐克的质量好一些，但是穿了两周后竟然开胶了！并且开胶的口子还不小，真是很不满意，本以为在优惠期间买是赚到了，谁知质量这么差。以后再买鞋要注意了。	negative
大宝产品不错，价格也实惠，是值得推荐的一个品牌。	positive
这书是盗版的，我同事买的内部的纸都是硬的卡纸而且特别结实	negative
就翻译来说，真的不错。但书拿到手，像旧书。纸张虽然低于预期，但闻起来味道不错。	positive
鞋子质量很好，款式很好看，上脚大小合适，也很保暖，走路舒服！很喜欢！	positive
愤怒的不仅是近乎抢劫一样的各种税收（我认为其实就是抢劫），还有作者本人的态度。书中多次提到税收调节收入分配的作用，多次用到“劫富济贫”一词，就好像这是理所当然的，我想问一句，凭什么？我不是富人，但我不仇富，因为我觉得只要是干净地不耍流氓地赚来的钱，赚多赚少是个人的本事，赚得多说明他给社会创造了更多的财富，你应该感谢他，而不是去抢劫他。 这本书除了一些客观事实有点价值外，作者的主观看法几乎全是错的，甚至让人怀疑他到底有没有基本的经济学常识	negative
印刷很好，促销购买，性价比很高，值！！！	positive
对于初学者来说很难，但是通过学习；发现这本书的编排真的很棒	positive
比专柜便宜太多，没敢多买，现在涨价了，好后悔。	positive
速度非常之快，书本也是很好！小屁孩很喜欢	positive
送同事孩子的，价格五百元以下，除了给红包就是乐高最拿得出手了	positive
价格真的很便宜，可是不能买有什么用呢？希望恢复购买后还能是这个价格，	positive
看了介绍， 谈论生死的大事， 也是我想深入了解的话题， 才买的。 开头引用了很多， 我也认真阅读，仔细揣摩作者想说什么，但感觉不得要领。 再看到后面， 很多对往事的回忆， 很多， 很细节， 还有书信日记的引用等， 我只能说我可以感到作者对她母亲深深的怀念， 却找不到我想看到作者对生死大事的进一步参悟，所以也就没再看下去。其实我也想说， 我感觉作者这部作品的发表， 对读者来说， 似乎有点不够负责任， 仅是我个人的感觉。	negative
快递很给力，三天就到了，鞋子穿起来也很舒适，至于质量以后就知道了	positive
现在这个年代，感觉人不够单纯，试想如果雷锋看到现在这个社会的老人自己摔倒找别人麻烦的事情，雷锋会怎么想？ 但不管怎样，雷锋身上有一种不怕吃苦，勇于奉献的精神，这种精神如果我们也都能学习到位，人生迟早会成功的。	positive
宝贝收到，和描述的一样，质量很不错，很喜欢。	positive
只图牌子了，衣服不知道是什么材质，很薄，弹力很大，看起来很低端。平时买的都是L码的，这个码数小很多，非常失望。	negative
关河五十州的书一直很喜欢，这本应该也不错，老爸正在看。	positive
不错,......................	positive
物流，产品质量什么的都还挺好的，一次很愉快的购物体验。	positive
样式不错，做工没有那么精细，镀金层太薄了，都磨完了	positive
特别粗糙，就是没有零星，物流十分垃圾。其中还收到骗子电话，让我提供信息，崩溃的一次购物	negative
特别漂亮，同学也都说好看。质量看起来也不错，喜欢！	positive
发货非常快，书本比想像中的大。很厚的一本书，里面的内容比较全面，非常满意	negative
拆开来竟然只有支架，螺丝都没怎么搭起来？非常糟心的购物体验，已申请退货！	negative
文章语句表达之差，不敢恭维！ 与原文虽然意思差不多，但是对比起来读，感觉十分晦涩难懂！	negative
这本书封面精美，内容丰富，能很好地激发大家对化学的兴趣与爱好。	positive
前面多是清朝人事，中间有点别的，后面全是介绍朋友。最后部分受益不少，总体感觉有些平淡，总算坚持看完了。	negative
用了一段时间了，感觉还不错，对得起这个价格	positive
在文中的文献引用，只有人名和时间，没有文献名！希望改正！	negative
宝贝很好，料子摸起来，很舒服。颜色也是很正，没色差。物流给力，客服也很热情，是一次非常满意的网购。我还会继续光顾的！	positive
虽然刚刚拿到书，才看了第一章。但其观点，尤其是数据采样部分，应该还是概率统计思路下的整理吧。大数据分析的一个最鲜明的特点就是全数据覆盖，不再采用小规模抽样。 不知道这两种思路的差异会给数据挖掘带来多大的差异。	negative
已经收到了，东西还没用，看着还可以。物流挺快的，用了以后再追加吧！	positive
物流快，包装好，没有折损。泰戈尔的诗集本人也非常喜欢	positive
不是一个实用的车，重要是：孩子坐着不舒服，设计上就不科学。孩子没坐多久就再也不愿意坐了。这次被同学的推荐坑了。	negative
确实是经典，作者的水平如此之高，令人赞叹	positive
画得真心不错：逻辑清晰，画风幽默。但是，但是，怎么只画到汉呢？太少了。	positive
都说清明前采摘的茶叶比较新鲜，果然这款口感比较鲜爽，茶叶比较嫩，茶汤看起来很干净，没杂质！很喜欢！相信老字号的品质！	positive
中国人为什么不行，在教育上，在老师上。整个教师群体有几个合格的老师？更别提好老师了。	positive
印刷质量很好，快递惊喜——下单第二天就到了。包装很严实，箱子+泡沫+塑封，好像易碎品的包装一样，还是亚马逊自己的物流，很棒！ 这本书是儿子自己选的，科幻故事，已经排成电视剧的小说，情节不必多言，喜欢的朋友绝对可以关注。	positive
总体来说这本书是自己喜欢的，其它的不做评价，感兴趣的朋友可以看看试读版再做决定。体会还有感受每个人是不同的，也不便讲太多	positive
是彩印的，不过好薄。也没有保护膜。就是用塑料袋送来的。	positive
新版的，考试什么的都是以这个为准，还有弄一本看看	positive
买过习题集的同学大可不必再买这本书，赘述太多，知识点较少。	negative
读完这本书我就按着本书的步骤做 脸上的痘痘好多了 真的	positive
我再也不会使用中国亚马逊了 希望你们能一直保持着低标准的服务 全球购 垃圾	negative
不错，东西还是很不错的，只是产地是柬埔寨	positive
一直用林内，这款用过一次了，这次又买，不错。	negative
超级好用，不管是作为底妆还是补妆的粉饼来说，都很好用，刚上去的时候，可能有假白，但是过半个小时，贴合皮肤之后，真的妆感超级棒	positive
书他自己纠错就罗列了500多点，有错可以理解，但是这么多错误出现，请问是手稿么？？？？那么急着发出来。然后很诚恳的发邮件过去咨询一个问题，呵呵 石沉大海。建议其他人找过一本其他的有项目的书籍再试试。	negative
感觉很奇怪，喷头喷出的喷雾是歪的，味道挺像之前买的lumene产品但是更加刺鼻，也并无什么保湿效果，包装也很塑料，表示怀疑......现在不太敢使用。	negative
不错哦。关于认识自己的不是很深入，但是对于日常存在的心理问题（嫉妒，自卑，迷茫，纠结）都能结合心理学进行解刨，找到根源，很有收获	positive
据说是亚马逊镇店之宝，现在每天都用一、两次，制作各种果蔬汁，家人很喜欢，用起来也很方便。	positive
嗯。。。其实，买来还没有用过，这个牌子嘛，总归好的	positive
音效很好，蓝牙连接手机也方便，外观也很好，很喜欢！	positive
很好，没有味道，娃玩的爱不释手。下次还会再买	negative
盒子又脏又破就先不说了，里面产品的做工也很不认真啊，还有松动的，还要自己按紧	negative
使用寿命就两年，2015年10月买的，现在2017年8月，两年不够，有点失望	negative
我当时查的时候说是国外购买的商家，买回来成了北京，不光国产还是本土产，根本不是国外品牌，赶上双十一看到某宝卖的大吃一惊[...]	negative
根据商品页面提供的尺码换算，朋友穿起正好！品牌、款式、质量都OK，其乐这个价，真的良心了	positive
实物颜色与照片相差太大，没达到我的期望值。皮套	negative
不想做评论，什么垃圾书，没有一点干货，全是网页截图，适合菜菜菜鸟吧。。	negative
这是一本很有用的书，它可以解决很多生活工作中遇到的问题，同时可以为一些生活中遇到的问题答疑解惑，我给五星。	positive
质量太差，亚马逊只能买自营的，其他的都超差	negative
这个海淘的，手感不是很好。一般。之前用过国行的。总觉得做工各方面比这个厚道。	positive
这才叫做描写，配的图片太好了，启发文化很用心！	positive
出去玩别的小朋友总有各种各样的零食，给自家好好准备的这个，算是爱吃。	positive
蛮不错的，我孩子3岁了，以为字多他不爱看呢，没想到蛮爱看的，就是多买了一本😌	positive
穿了一个月,两边鞋子都开胶.....还能说什么.300块打水漂?	negative
主要写作者去了什么地方已经简单的神话，可读性较差。	negative
收到了不能打中文，痛苦啊，型号应该标注清楚，欧版，亚洲版	positive
一星是给亚马逊的，我想问问，我在亚马逊买了书，为什么会有宁波的骗子有我的订单信息？！为什么我所有的资料骗子都知道？！是谁泄漏了我的信息？！还好我防没有被骗，要是稀里糊涂被骗了谁来担责任？！	negative
纸质，质量等都还好，就是光盘没有用，叫人怎么自学！	positive
送货包装就一个塑料袋，就一个塑料袋，就一个塑料袋，收到快递是塑料袋破了，书皮有破损！！	negative
订了四本书，有一本是破的，硬皮书都压破了，不开心！	negative
看仿生人和电子羊的时候就有很明显的感觉。后人在影视上的改编使故事更加完善，可信度更高，也更自然。菲利浦的原著更像是一个框架，这个框架本身比较粗糙，但恰恰因此具有了很大的延展性。先看了影视再来看原著就有点失望。	negative
应试还能用，逻辑思维增强了些，但不以长期提高写作能力。	positive
书下了订单两周还不到 不知道这个店是用自行车配送还是怎样 没法理解， 在申请退款之后 邮费还给我恶意扣除 耽误这么长时间 还反倒扣我钱？有点业界良心吗 你是有书还是没书？ 是不是专门赚退款的？ 以后可别再碰到了 亚马逊有没有屏蔽功能？屏蔽黑心卖家	negative
裤子很好看，也很合身，质量杠杠的哦，活动时候买的，超级给力，超级划算	positive
个人觉得不太容易坚持看下去，交往还是需要多多实践。	positive
一直购买，性价比不错，只是孩子大些了晚上侧身睡会漏尿	positive
亚马逊作为一个销售平台 对于出售的货品 就直接让消费者和供货商自行协商解决 作为一个知名企应该承担起更多责任 代替消费者去解决产品上的问题 而作为卡西欧的供货商 我倒想问问 手表不佩戴怎么发觉问题？居然回复消费者“商品已经佩戴 不符合退换货标准” 这种态度太让消费者寒心了 才刚买的手表让我送去位于北京的维修点修理 真是无语了	negative
不是很推荐哦，焊接的地方处理得不好，感觉一旦有太多太重拎起来手柄会断那样，还有这个容量实在太大了一般用不了那么多	negative
千万别买，用了五次就坏了，充不了电！关键是400的客服号码根本不存在，正在联系消协维权！！	negative
刚到货，六年的女朋友就和我分手了。我决定给个差评	negative
以前从不去评价，不知道浪费了多少积分，现在知道积分可以换钱，就要好好评价了，后来我就把这段话复制走了，既能赚积分，还省事，走到哪复制到哪，最重要的是，不用认真的评论了，不用想还差多少字，直接发出就可以了，推荐给大家	positive
内容安排有些杂乱，没有一个很好的系统化学习的可能，给4分	positive
昨天买的25今天就降到19了，真是够了。	negative
这本基础训练是老师推荐我用的，比较适合我这种基础一般又想考研的同学，这本书的题型题量都比较丰富，答案解析很详细，真的是很不错的一本资料。很赞哦！！	positive
即使将kindle版存在的技术问题抛开不谈，本身也不是一本值得购买和阅读的作品。	negative
品质不错，美中不足是侧边的音量按钮部分按起来 费劲。	positive
之前一直食港版的、第一次食荷兰版，有点疑问，这个奶粉一边吸一边起泡泡的！有点不放心！	positive
虽有商业炒作的味道，内容还是给人以启迪；翻译质量评80分。	positive
内容自不用说。 但说排版，用纸，厚度，都是一流的。绝不逊色于港台书籍。爱不释手，爱不释手！！！	positive
买了之后放在家里一直没看，今天拿出来看的正开心，发现缺了二十多页。。。。。不知道是不是我运气太差	negative
书很好，个人比较喜欢佛学，希望通过这个更好的了解佛	positive
本来开发票就没有问过我细节，佰搭达乱开发票导致我发票不能使用。 我协商说寄回发票后作废重开，且将正确的开票信息发给它，竟然被拒绝。 专用发票都能作废重开，佰搭达竟然不能，我强烈怀疑公司有问题。科科！	negative
儿童防蛀牙膏非常不错，保护牙齿，价格公道，就是孩子不怎么用。	positive
本人大学生，有一段时间很迷Clarks的沙漠靴。。。这双鞋就是在这个时候买的，这款不是生胶大底的，很容易沾灰，总体来说还算满意。Clarks的纯正生胶大底的沙漠靴也在TMALL旗舰买过，都有一个特点就是鞋底脚后跟的右侧非常容易磨损，建议穿之前去打个底，不然影响寿命。最后，翻毛皮的不好打理啊。。现在已经过了狂热的时期。。没怎么买沙漠靴了。	positive
还行，不卡，好看，但拿着手不是很舒服，边上太薄了	positive
坐着感觉是一位跨界的斜杠青年，靠着自己的好奇心，在硅谷成就了自己的一番事业 我坚信成功的因素不只有一个，而作者就通篇拿着好奇心这个 观点，来回的套故事，的确有一些独到的见地，但是没觉的和压榨式提问有啥关系，所以打分偏低	negative
背部支撑做的不好，太小的小孩怕引起驼背。还是有诸多不足，可能这个价位也只能做到这个水平。	negative
借这个评论，吐槽下之前买的衣服。衣服是2月4号下单，然后等了两天东西还没出库。给客服发了两天的邮件一直说在催促配送公司，然后又花了两天给客服打电话，得到的答复是：包裹可能在出库的过程中丢失了，没有到达配送站。彻底无语，当然这还不算完，申请退款至今没收到。后悔之前用支付宝把钱给了，没选择货到付款，就是担心自己不方便收快递，怕麻烦别人才在线付的，结果给自己找了这么大麻烦。以后绝对是选择货到付款了！	positive
有特色的社科类书籍，喜欢dk系列书籍，折扣期间收集了一套	positive
大概翻了下，里面的专业的东西太多，生物学都进去了	negative
正品！很nice，我觉得男士的也可以推出精钢表带	positive
对我来说这款暖被机真的很实用，冬天家里的垫被都比较厚重，晒在阳台外比较费劲，现在有了它省力多了	positive
做工精致款式新颖 面料很好 穿着很舒服 满意	positive
没听过的牌子，原本不敢用的。抱着试试的心态，没想到还不错，纸质不会太粗糙。 唯一的缺点就是，开端胶水用太多，每次拿新的出来，都要撕半天。浪费好几节。	positive
差评给亚马逊客服，不针对商品本身。除了会说请你耐心等待，解决不了任何问题，而且一点诚信意识也没有，说的24小时内的回复基本收不到回电话。亚马逊是行业标杆，可惜中国亚马逊臭名远扬，对不起亚马逊三个字。	negative
好看，但闹钟好像坏的，设置好应该不动的，但他会自己走。懒得换了。	positive
东西非常好写起来特别顺，价格也还不错，喜欢的不要错过哦～～	positive
到底是仓库还是物流有问题。有一瓶盖子破了，酒撒了。	negative
除了纸质比较好以外，都是蜻蜓点水，不得要领。	negative
非常好，质感气味跟我从韩国带回来的一样，用起来也一样，很好用	positive
不好，插头太短，插到车的点烟器里面不牢固，车子颠簸的时候经常掉出来，不好 SAST 先科 AY-T11 点烟器双usb 带开关车载usb充电器一分三 一拖三点烟器...	negative
用了差不多四个星期，漂过的头发由原来的淡黄色慢慢变成白色了，虽然有一些还是泛黄的，相信一段时间之后就可以变成全白的！！	positive
实在太小！其他评论都是扯淡，180，130斤，看其他评论都是M码，就买了M根本穿不了！平铺实测腰围33，*2也才66的腰围能穿，不到二尺！也不知道别人都啥杨柳腰才能穿…	negative
好，以前从不去评价，不知道浪费了多少积分，现在知道积分可以换钱，就要好好评价了，后来我就把这段话复制走了，既能赚积分，还省事，走到哪复制到哪，最重要的是，不用认真的评论了，不用想还差多少字，直接发出就可以了，推荐给大家！！！	positive
特别失望一星给亚马逊。亚马逊购物多年，第一次碰到非全新品。手机外包完整，打开后发现充电器有划痕，屏保歪斜有气泡，电池只有一半，一看就是非全新品。手机还在试用，没问题的话还是准备留下。非全新品不是应该放在Z实惠吗，很失望	negative
真的按照刻度来用的话，只能用12次，太夸张了吧。不过有人说用过像新的还真没有感受出来啊，你的内内本身就是新的吧，没那么夸张呀	positive
1299的不是套装吗，为什么就一个手机，连耳机都没有，比官网直接贵两百，	negative
脚感比亚瑟士要差，，，但是我买的亚瑟士右脚破了个洞，就没有什么舒服又能穿长久的鞋子么	negative
啥吗，拿来的时候很满意，做卷子的时候打开一看，第二页完了就是第五页，内容不衔接，让我怎么办	negative
已经用上，很好。屏幕分辨率较低，手持端无法远程操控摄像头。	positive
一个月不到就无法充电，自己去小米的维修点算是免费修好了。小米的品质不行啊。	negative
很清晰，可惜字还不够大。是我贪心吧。写大楷的话，看着有点小。	positive
制氧机很好，但是送货服务需改进。因为物品较重，仅送货到小区门口是远远不够的，建议亚马逊的物流今后对这类大件物品应送到家门口或电梯口。	negative
宫斗小说中的经典与巅峰，建议看完后去看如懿传，但注意：如懿传是接着电视剧版本的甄嬛传的，而不是接着小说版的甄嬛传的	positive
身高181，体重92，L号正合适，但是这件衣服与图片不一致，材质太差不柔软，烫的痕迹太明显。	negative
真的很一般，没什么特别之处，无非是科普知识，运动睡眠营养有利健康。	negative
"有时买的“万多FU""可以达到这款的质量，有时达不到。 总之，这款开心果，买了三袋，袋袋高质量！"	positive
耳机的外观还好，但是明显非常硬，带起来的时候还行，挺舒服，不会感觉硌着。音质欠佳，寿命不长，两个星期不到就坏了。	negative
今天收到，试了一下，初步感觉还不错。暂给四星。	positive
唉，怎么描述呢，就是伞骨的头，有一根，坏了，不知道怎么修？ 我在京东买的东西，用了很久坏了坏了可以修，这个伞，售后在哪里啊？？？	negative
照片上是黑色的，其实还有一个透明的，小小惊喜！	positive
我没有退这单的货！客服小姐足可以去查录音！！！！！！！！！	negative
这茶味道怪怪的，不好喝，只喝了一袋，就喝不下去，效果看不出来	negative
只能说这个价钱可以了，不过不是真皮，不知道会不会掉漆！	positive
看完后挺失望的，也怪我买前没看清楚。20个感人的故事在我看来就跟网络YY小说一样。充满了拜金，419，酗酒，飙车，炫富，装逼。里面的女的都跟碧池一样，婚外情也能被作者写的理所当然。搜了一下作者，也难怪了。生活在那种圈子的人写出来的自然是那种纸醉金迷灯红酒绿的东西。也别被书名的清新骗了，内容吧，呵呵。	negative
亚马逊也是够了！虽然这书容易库存，可也别给我买6本坏3本啊！	negative
质量并不是特别好，当我组装的时候接口处就已经开始变形，而且那些珠子仅是塑料，总体来说比较失望.	negative
今天心情 嗯 挺好的。这是一条诚意满满的评论。 味道。。。不合我的口味。略甜 略苦 后味有酸，但是没有咖啡的香味，没有 没有 没有。 以上	positive
以为是讲玄幻的，原来是说做人道理的。有教育意义。	positive
比想象中的大，用着还好，噪音方面能再降低点就完美了！	positive
第二次购买了，这次苹果有碰伤，不是两三个是多个。还是很好吃的。美中不足把，商家这方面要注意。	positive
产品没有说明书，没有保质期，甚至连外盒子的封贴都没有，其他都不用说了	negative
第二次购买了，感觉味道比Fruit d'Or的好 物流很快，卖家服务很及时。	positive
大小挺合适的，就是肩带不能调节。。不知道是不是正品	positive
43码的没有，只有43.5的，大了一点，能穿。 款式是去年的，不过还是可以	positive
之前买过揭秘低幼版，儿子非常喜欢。整天拿来读。汽车和机场已经翻烂了。最近变身小恐龙迷，赶紧给他准备了这一套。非常非常喜欢，家长跟着也长了不少知识。	positive
书还不错 ，就是发货时间太郁闷 ，越来越差了	positive
不过很好的是书后面还有一张网课卡，可以让兄弟好好看看	positive
耳机声音一般和电脑城几十的货差不多，耳套做工粗糙，基本没隔音效果，声音开到最大可以当音响用了！	negative
太薄啦 空间挺大 但是 格局分布也不好啊 这个价 怎么说呢 一分价钱一分货	negative
一个与张有工作关系的女人的碎碎念，不是传记，不是评论，零零碎碎的。作者自己的感悟比事实的描述还多。没什么内容。不推荐购买	negative
小巧， 吹风也确实凉快。 但直流充电才用三天就烧坏了。 用电池的话， 一天就要用掉两三节。	negative
买的书比别的网站贵也就不说了，谁让其他的网站刚好都断货呢。可你的书贵就贵吧（当然是贵十几块呢），能不能把定装和封皮搞好一些，收到书后老婆简直无语了（是给老婆买的，老婆爱看书），这包装也太糊弄人了吧。附照片	negative
是水泥的！不是铁，我11月1号买的，11月13号才到货，这是什么快递？！ 水泥的不重，一块最大就5斤，直径15cm,根本没法做运动好吧，还不如去淘宝双十一买，我真的服了。 买个教训，亚马逊我看就kindle好点，其他都渣渣。	negative
我买的是明明全脂奶，可是味道非常淡，没有奶香，也不醇厚。拿来泡咖啡就特别明显，咖啡加了它之后还是那么涩，就跟加了脱脂奶一样水平……下次不买了。	negative
少了一颗星是因为索大发也太抠门了点，说是无线控制器就是“无线”，包装里面连根USB线都没有，我还得找其他的线去充电	positive
好多册封面、扉页、正文、图片排版错位，每一册的格式也不统一，有点乱。	negative
买了这套三本，印刷质量和排版什么的完全就是盗版的感觉。买过同一个英国出版社出的一套game of the thrones，从纸质到印刷到排版比这个好太多！严重觉得这书不是正版的。	negative
书不错，纸张厚实，印刷精美，内容充实，每张作品都很精彩，适合有一定绘画基础的学者。这次买书唯一不满的就是快递。。太慢了。。真的太慢了，卖家要是看到留言，放弃天天快递吧，随便一个快递也比什么天天强，买书的要联系卖家指明要发什么快递。	positive
很满意的一次购物，宝贝与详情上基本无差，孩子很喜欢	positive
外观美，质量差，用不到两个月左上角和左下角裂开了，很爱惜宝贝的用法。	negative
非常喜欢的一本书。虽然没有拼音，但作为二年级的小男孩，已基本能读了。还有插画。	positive
很帅气的 很喜欢 也挺合身的 质量和做工都很满意	positive
以后这个是常购的了 不错的电池	positive
出水不太好，都画不上去。有点失望。东西送的挺多，但是都没什么用。	negative
用了一天，发现2号盆子底部色彩开始脱落，	negative
图文并茂，儿子5岁多，每天睡前一故事，很喜欢，系列都要买齐	positive
说好的图文并茂呢？一张图都没有。这是为啥？！？但是文字内容却是很好	positive
外包装总体感觉还不错，内容未看，暂不评论	positive
不开心 虽然我写错了电话 但是我标注了周末送 等我上来一查 已经准备回到原来的地方了 而且我找不着商家电话 快递员的电话也是没有的 打座机总是占线 我都不知道这是怎么了，让我如何相信还有真爱	negative
你大爷的，亚马逊居然卖假货...明明是海外购，居然还是made in china ...居然都没有吊牌...居然盒子上写的2016年6月产的...明明是山寨的	negative
一部非典时期背景的言情小说，而不是经管类书籍，感觉很坑。	negative
书页印刷很奇怪，有很多跟文字对不齐的背景图片一样的东西，感觉有问题可能是盗版	negative
特别难吃，可能是被蓝罐和非凡农场宠坏了，感觉这个真的不好吃。。。	negative
刚看了开头。听了写作老师推荐，是为了提高英语感觉的，所以买了这本书。但是书里有一页是烂的，自己拿透明胶粘好了。	positive
手表样式很喜欢，但是昨天也就是买了不到一个月的时候，时间竟然突然慢了十分钟，想退换货还不允许，不知道是为什么？不是三十天可以退换的吗？蒙圈了	negative
这家公司发的货与图不匹配，退货时产生的运费46元说好返还的不给，在亚马逊买东西也不安全，真倒霉	negative
本来以为是全部出自沈石溪，没想到是多人的作品。另外《天鹅之死》从87到106页全部印错，很失望😞 以为是亚马逊全部是正品来着…	negative
内容不错，有细节。装帧不行~没看几次掉页了，只是扫描了几张图片，中封一展开就掉页。	positive
昨天刚买，还没收到货，就降了十一块，还免运费，真心不爽！	negative
还以为买了名牌货，退货期也只有一个月。质量有问题都不包退，打印出来就是这样了，开始时就一个个点，现在就大横线都出来了。只是我买这个东东的体验。无语.......	negative
汇聚了不同类型的饱含泪水和温暖的短篇故事合集，不知多少内容曾戳中我的心脏....，我是在高三那年买的这本书	positive
153/45，买的155/80，质量不错，大小合适，只是不知搭配什么颜色	positive
内容庞杂，但是义理精深，学习起来对初学者有点难度，我现在还看不懂，相信有懂的那一天。	positive
裙子收到了！卖家发货很给力！质量很好！穿起来朋友都说好看！谢谢卖家！	positive
包装精美没有用，产品不是一般的差，是极其差，小还可以送人，连抹布都不如。难道七匹狼要退市了吗？退货麻烦，当然你们可以让物流上门取回。 钱可以捐给红十字会。就是不想操心退货的事情！	negative
手机是正品，官网验证了的，就是右上角有点松，按压有响声，好像是通病。还有就是亚马逊委托邮政速递送货， 发错了地方，折腾了好几天才到手，希望改进。	positive
上脚舒服，也很漂亮，多大脚买多大码，因为有系带所以不怕，皮面很好上层牛皮，内里是人造革，所以一分价钱一分货。	positive
不错，沉甸甸的，货真价实的好东西，果断好评	positive
买的时候客客气气，发现尺寸有点大要退货就磨磨叽叽，最后也没退成，说我寄送快递的时候把洗碗机放反了导致有磕碰，难道快递公司就不会把箱子倒着放，那不也有磕碰么？最后白花了一笔钱，家里没地方放，送人了，坑！	negative
书挺新，但其实实验书真的不会脏到哪里去啦_(:з」∠)_	positive
雨刷质量太一般了，用了不到两个月，胶皮就有脱落的迹象。	negative
之前399买了蓝色的同款，感觉不错，想回购时涨价了。3.14那天大促，以299+1也就是三百元的价格买了这款。感觉太超值了，想再买，无货了。商家发的是顺丰快递，三天半就收到了，包装很好，打开后椅背上有两个小线头，剪去就好，此外感觉堪称完美。期待下次大促时再购。	positive
除了差评。我不知道还能说什么，亚马逊，你是想怎样，一个问题，一个星期都不解决，还找不到投诉路径，看来只能工商局了。	negative
送货及时，第二天上午送到，包装就是一个大的亚马逊纸盒，里边就是商品，能不能建议下下次在里边放一些填充物吧，商品在里边咣当来咣当去的，难免会有外观上的瑕疵，还好这个不明显，但是边角也已经有凹进去的痕迹了..... 这个是送人的，所以说的有点多了，要是自己玩就不会废那么多话了。	positive
鞋还可以，也许是快过年了发货的等待时间有点长。 按250CM脚长买的40码，结果太小了，得买大一码 正在退货。	positive
亚马逊和电信诈骗配合得太好，买本书被骗子坑一大笔。	negative
带着洗澡不知道为啥变成黄色了，一部分黄，一部分银，看起来有点难看	negative
第一次在亚马逊购物，亚马逊也卖地摊货，让我失望，哪来的真皮，还不如布的，	negative
值得回味 小时候的回忆 在手机上看还是很合适的	positive
仓库里放了10个月的咖啡，可以说是非常的让人难受	negative
优点：长度就够了，大度可以。缺点：异味有点大，材质有改进的地方，洞口不够真实，有代改进。	negative
当初购买后没有仔细检查，如今阅读到后面才发现有2处严重的纸张破损（之前未拆封）， 已经过了退货时间只能认了。。如购买请注意！	negative
翻译的很好，不艰涩，值得静下心来好好读一读	positive
15年9月份买了，四个月左右鼠标的滚轮就不精确了，怎么办，保修找谁，怎么联系卖家	negative
查理九世(1-26)(套装共26册)收到，给小孙子买的，一收到可高兴了！物有所值。	positive
贴合的很好。一开始残留的一些气泡过些天就自行消除了。还有几个不足之处，一是听筒处容易进灰尘，倒也不影响使用，二是全覆盖贴膜的问题，可能会在通话完远离耳朵的时候仍是黑屏（貌似是全覆盖贴膜的通病）	positive
五星给笔，非常好用。二星给亚马逊的运输，速度太慢了，特别是自提服务。希望能改进。	negative
172+68，买的L号，有点偏大，看图片以为是cool 系列的料子，结果是棉的。吊牌居然不在衣服上，在外面塑料袋子上	positive
好像不能退货 当时是想包邮 就买了 不好用 味道不好问 便宜没好货啊~~	negative
亚马逊配送员都是大爷，还得让我去离我很远的地方去拿，我要有空去拿，还要快递干嘛？！更何况我要有空还要在网上买书吗？！这就是差评的理由，不是针对商品，而是针对你亚马逊的服务！你们自己反省去吧	negative
从未带耳机下水，也未沾过水，不到2月就不能开机，请求售后帮助维修哪怕自己付邮费都行，回答是请找本地的。我们不管 如果本地有会选择邮购么？一套买来一个多月的耳机就这么陷在手上。 因为一直是美亚用户所以回国后选择中亚购买，结果这状态也是醉了。什么中亚开什么海外购，是卧底来专门败自己名声的？？ 只一句，所谓中亚，所谓海外购，要用的都小心吧！	negative
用着不错！音质在这个耳机价位应该算是最好的了	positive
第二次购买。很喜欢这酒的口感，果味浓，很清新。	positive
刚入手，感觉包装一般，二维码扫描不到信息，怀疑是假货，不知道有官网直销，建议大家去官网买，有保障，即便是亚马逊，也是鱼龙混杂，给大家长个记性	negative
不是专业的，也不太懂。买来送人的。包装和外观很OK	positive
衣服的肩宽，袖长都没问题，就是衣身有些过于长了- -#可能就是这种风格...	positive
很棒，虽然价格没有优惠，快递速度不错，东西也好用。	positive
此系列的书买了很多，纸质不错，而且不反光，	positive
此书既然叫做新编，说明市面上其他同类书籍里的内容和这本书不是完全吻合，有些概念的提法不一样。每一章都配有问答题，方便自我检测，是备考南京大学俄语语言文学专业的指定书目，书挺薄的，价格有点小贵。	positive
喜欢这种笔 容易吸收 很愉快的购买经历 快递很快	positive
1.76，60KG，30*32刚刚好，和以前专柜买的号一样合身。产地孟加拉，质量和专柜一样吧。不过这是弹力系列，穿着是很舒服，但网页上怎么没有看到有这个信息呢？这方面应该改善！	positive
烦请尽快开具发票，否则无法报销，非常感谢！企业名称：广东智酷电子商务有限公司 税号：9144060609179436X3	negative
14年9月份购买，15年1月份左右，笔杆开始掉漆，上周（15年3月份）发现漏墨水	negative
有部分是历年真题里的。 讲解很一般，就是找出原文的整段翻译出来，没有分析，没有技巧。不适合入手。	negative
详细了解了多囊卵巢综合征，比两眼一抹黑只吃药强多了！	positive
唉，衣服样式不错，衣服偏大，一次买了6件，没想到只有一件能穿，一直相信亚马逊，可是衣服、鞋子色差，号码偏差太大，有点失望	positive
偏光效果很棒，给老公买的，每天都要跑车，戴上还是管用，舒服多了	positive
无用的内容太多，字间距又大，一本书讲完的东西弄成三本书。	negative
一颗星都不想给，里面东西太杂了。都不知道要讲什么。	negative
贴合度略差，尤其是中下位置； 不是全包，估计手机有磕碰风险； 侧边接缝处不光滑，有明显的楞； 整体不值这个价钱。	negative
萃取的时候有点漏水，贴合度还是没有雀巢的好	negative
保温效果好的很，4个小时不插电都没凉，工艺精美	positive
买来送给朋友的，非常好，上班工作家里老人孩子的都可以用推荐 送礼佳品	negative
非常好用，不会伤手，宝宝一只手都能伸进去摸零食，解放妈妈喂食。	positive
铜片设计太差，一字插头插入大都接触不良，49元不值。	negative
还没看，纸张不错，到货很快，快递员很细心的给我做了个提手，方便提。赞一个	positive
当时买手套主要是孩子练习引体向上用，戴上之后挺酷的，孩子很喜欢。	positive
我是给了运费的，卖家为何要选这么奇葩的快递，送了快一个星期了	negative
货送过来固定螺丝的接口是坏的，和卖家达成一致出80元我自己去维修好！	negative
为什么信息显示昨天上午到自助取货点，自助取货点说没有见到货品	negative
差评给快递，收到货的时候，外包装盒子已经破破烂烂，里面的小盒子也都压坏了，这种服务非常失望！	negative
超级赞 简直惊喜 一盒颜料都得70了 这一套69 质量很好 很适合小孩	positive
昨天到了物流速度一贯的快，打飞利浦售后一直无人接听只有自己安装还不错画面清晰但联接wifi老是卡资源少 。 做显示屏分辨率低	positive
其实从来不看这类的书，觉得都是老人家们才会感兴趣，看见页面有，就随手买了。看了才知道，原来中医说的“肾”不是西医的“肾”，中医的“肾”是个泛指概念，是一个大系统。书里还说除了调养五脏六腑，情绪的调养也是关键，脾气顺了气血运行才能同样顺畅。看来自己以后还要注意一下了。	positive
不好！用了两天听着听着就自动关了音乐，有时候还开不了机，气的我卖回来第三天就把它给砸了。	negative
为什么使用百世快递？太慢了，原来ems很好，很快	negative
简直太坑爹了，链子换了一次第二次还是缠着的，废了半天劲才弄开	negative
鞋垫太厚，后鞋梆子太短，感觉穿着不是太舒服	negative
经典的动画片，怎奈配合的故事文字实在是牵强粗糙了点，纯属画蛇添足。出版方这么担心没有文字的配合，小读者无法理解画面的含义吗？学学那些出色的无字书吧。	negative
非专业别买了，没用，枯燥乏味！给俩颗星，辛苦作者，辛苦出版社了！	negative
样式还算可以 中国产的美国品牌，商品介绍里没有写产地，感觉被骗	negative
对烫染的头发有很好的修复功能，自从用了这款发膜，我的头发就不开叉了	positive
为什么本品跟我收到的不符合呢、写13.5、我收到的是13。灌装竟是2015、9月、酒体很冲、怀疑勾兑酒	negative
1、买的时候告诉我是第二天就能到，结果并没有！！而且是你们物流发错地了！！！ 2、你们给我开了一个华为手机的发票是怎么个意思？！且不说你涉嫌偷税漏税，我这边如何报销？！ 3、包装可以再简单一点吗？专柜买货都有手提袋你们的手提袋呢？！ 4、就一个小盒子，而且每个拐角还被压坏了！能再low一点吗？！ 5、完全失望的一次购物！对国内亚马逊彻底失望！我不相信在国外你们也是如此！	negative
买了一个月了，用着真的不开心。其一，喷嘴的弯管连接不牢，用一用就需要向里推一推，要不就滴漏水；其二，只能用在矿泉水桶中，那样接口正合适；其三，已经充不进去电了，看来出游带上也不方便的。我个人觉得，最多值几十元钱，不值目前的价，不建议购买。毕竟总是看别人的评价，也得提出点真实评价。	negative
这本书带你大致的过了一下移动端所用到的几个基础的技术点，从技术点出发，带你亲身实战几个案例。虽然我在阅读的过程中发现书中示例代码有些错误，但整体来说，本书值得那些相接触移动端的朋友去阅读一下	positive
什么破机子，用了不到半年，反映相当迟钝，现在打电话都很费劲	negative
如果你们恰巧经过查令十字街，能否为我献上一吻？我欠她良多。	positive
平时穿36码的鞋，这双买的4.5m偏大了，应该买小一码比较合适。还有鞋子比想象中软一些。	positive
1、到货手表表带有明显瑕疵，后盖左右缝隙差别很大。 2、反馈以后，说让提供照片，拍了照片传给客服，客服回答说传给领导需等待几天。 3、等了几天说再发点图片，我就想，我是亚马逊的售后服务支持吗？怎么不让我再做个检验报告一并传回去。 4、后来客服没给回电话，也不管了，从未见过这样的亚马逊，服务态度极差无比，对质量问题居然如此不放在心上，真是令消费者汗颜的500强公司。 5、就产品而言，2500块的表还比不上淘宝的山寨货。 垃圾	negative
连耳机都没有还敢送过来，对你不是失望，是绝望。	negative
还好吧，孩子睡觉挺好的，中国人的产品还可以	positive
身高183，体重75，买的m号还是有些偏大了。看衣服标签上写的是美国、墨西哥、欧洲都是M码，亚洲就变成XL码了，体型差距要不要这么大啊。所以不是太胖的话建议买S码就足够了。 衣服挺厚实，里面是绒的，穿着挺舒服。不过比较掉绒，最好先洗一次再穿。 物流相当快，买完1周后就到货了，我都怀疑是不是国内仓库的存货。不过看快递上确实是从美国发来的。	positive
质量不错，大广角超清视频显示效果细腻，散热效果不错，功能齐全，24小时保护您的爱车，值得拥有。	positive
非常好的书，文字幽默，阅读方便，一套全买齐了	positive
跟超市里买的对比了，颜色不一样。这里的是浅橙色，超市里的是一般奶粉米白色，不知道真假，郁闷	negative
肯定盗版，气死了，重复印刷了两个单元的内容，还等了那么多天，失望至极	negative
这是一本发人深思的书，可以为迷茫的人找到一定的方向。其实现在无法评论，只有坚持做了才好真正的评价。	positive
就是装订如果是骑马钉就好了，这样就不用拆书了	positive
这是书是老师推荐的，可是感觉完全不实用。不值得买。	negative
还没有看，速度还是蛮快的。期待书的质量！	positive
救活了一对老音箱，效果跟连接以前老安桥功放一样。现在可以连电脑，连手机，只在桌角占了一点地方！不是发烧友，感觉不错就好。	positive
质量好 样式好看，手感不错 很喜欢 值得购买.	positive
里面说的是cs6，根本不是cs6，光盘里带的视频根本不是书里章节里的东西，不知道是什么。买了本垃圾。	negative
比巴掌稍大，活动折价大概七十多，还是比较贵，牌子是美国的，国内代工，送人还是小气了，补充，眼睛不是纽扣式的，平面的缝制，没眼神	negative
8号下单，今天18号还没收到货。客服电话打不通，查配送记录，说已签收。我地址是上海，最后签收的地址跑去了深圳。从未有快递人员联系过。晕	negative
非常舒适，戴眼镜也不卡耳朵。游戏上感觉比Aurvana Air强。	positive
不推荐购买，因为穿了3个月不到鞋头和帆布拼接处就爆开了，300多买来的鞋，就穿了3个月，质量差差差。	negative
看到亚马逊打折就下单了。确实是韩国制造，标签上一个汉字也没有全是圈圈杠杠，质量不错，玻璃很厚，盖子做工精细密封严实，重量很足。个头不大，当个碗用没问题，微波什么的都可以。记得大概是15元吧，很划算。我非常满意。	positive
很小一瓶，不过很喜欢这种香味，效果也不错	positive
盘了一段时间后，发现珠子有裂纹，并且还发现很多颗珠子的表面上是上过胶水的	negative
我194买的，今天在超市见到145就可以了，，感觉被当成猴子耍了一次。后来又发现把铁罐（900克）包装换为纸盒（1200克）包装仅仅170元。	negative
结局没有想象中精彩，但题材和故事连贯性，感情亲情爱情友情的细致刻画足够令人回味！	positive
个人觉得，这本书需要很高的专业背景才能读得懂；想想也是，要想搞懂第一推动，哪有那么容易啊。不过整体来说还是有那么一点点小收获吧。	negative
8张唱片中第5张有一首曲子“梦”录的有毛病，其他都不错，还较满意。	positive
一个感觉：又破又烂，不知从哪翻出来的用过的感觉！	negative
言情小说里写的很不错，太感人了，一贯的悲剧	positive
一拿来就是快递的袋子，书没有那层薄膜保护，坏了一点，应该是包装之前就被人为损坏了	negative
花很美，有按季节和节日设计的作品，也有很多坐贺卡的素材。	positive
一直用的iMac,原装的无线键盘，所以看到时候，就是觉得挺便宜，但是毕竟没有原装的质感嘛	positive
上课上到131页才发现有个洞洞，字都看不了！！！！！	negative
我算是真心服了，Z秒杀买的98￥，结果，第二天价格比Z秒杀价还便宜20￥，这是拿Z秒杀开玩笑么？	negative
不实用。还是买内胆包实用。背带太硬，脖子容易痛。	negative
这书可能适合于研发或者开店的，知其然然后搞懂所以然，普通家庭读者甚至于一般的烘焙师我觉得都只能算是翻阅而已，因为极为全面的介绍了面包加工的各个方面，包括各类加工机器发酵原理差异，但我可能只关心面包手工加工这一块，本书说的是各类基础理论，但具体操作手法或者手工操作的细微差异，不是本书的涉及范围，还需结合具体操作的书来看，	positive
正好赶上搞活动 全下来不到300块 儿子喜欢的不行 83高 13KG 1岁4个月 玩起来没问题! 做工也好 表面都很圆滑 唯独就是有点轻 孩子淘气的话怕倒了	positive
第二次买z实惠的东西了，每次都需要退换货才给我发能用的。。。。。。。。。。。。。。	negative
大年初一厨房龙头坏了，跑了半个城都不营业，更不要说找水电工了，想到亚马逊节日还是坚持送货的，找了亚马逊自己配送的产品，从下单到送货一共花了20小时不到，自己动手15分钟搞定。亚马逊的速度和服务实在是杠杠的。龙头比想象的大，重，当然比较结实。就是上前应该加个垫圈，因为拧紧了还是跟转。	positive
我以为颜色如西藏的天空一样深蓝，没想到是多云，白色的云雾中露出一丝丝蓝。	negative
老公说今年也想要一双切尔西靴子，兜兜转了一大圈，看上它了，性价比合适。收到感觉也很好，穿着舒服，说上脚轻巧。在亚马逊买鞋我都成精啦……真的非常不错！！！本来想加照片的，只是老公穿着上捷克出差了，下次补上。	positive
如果大家有想法购买电话机 大家要做好自己要找品牌产品售后的心里准备亚马逊是不负责的，我买了电话几个月就出问题了，长沙当地飞利浦电话维修中心说不接收网购电话的维修，找到亚马逊售后服务中心，他们只会说要我自己联系深圳的厂家然后快递过去，就是纯粹一个踢皮球，谁买谁后悔的，说到售后 真心不如人家京东 苏宁，以后我是不会再来亚马逊买东西的 无论多便宜，深深体会到店大欺客四个字	negative
这款SSD是个主控很差的MLC产品。所以价格还不错，不过在这个物流运输过程中我在张大妈看到几次国内同款更低的价格。而且物流太慢了，超时5天。	negative
内容不必细讲，但物流直接用塑料袋包装就送过来了。物流速度给满分，过程直接一分。	negative
保温效果不错，款式也喜欢。唯一不满意的是气味很重。	positive
书很薄只有111页，还有故意写的很大的字，不过，内容还行，dom动画，文本动画，svg动画，如果想知道怎么学这些，可以买来看看	positive
女儿很喜欢，不错，以后还会买金波的书给孩子	positive
收到书，划痕很严重，纸质很糟糕，但愿文字内容别出错	negative
感觉一般，没想象中的那么好。不过没有味道。这点不错。	positive
去年还是上学期买的去了。到现在为止还没有坏。30块买到很值，看到之后就涨价了。每次做烘焙用来秤，很不错	positive
很不错，各种喜欢呀，感觉有点浅，盖不住刘海，还要把头发往上翻	positive
物流太慢了，5天才到，同一天在当当买的另一本书两天就到了。	negative
排版有问题，有大量的重复文字排版有问题，有大量的重复文字排版有问题，有大量的重复文字	negative
拿到书好几天了，终于有时间打开看一看。结果傻眼了……书不知道是有多旧，边上的纸都发黄了，后面几页全都是脏的，像是在地上蹭了一样。失望。	negative
被图片欺骗，实际效果差，不建议买。而且其他网站还便宜，不过评价都不好。已经换了。	negative
不知道为什么，一收到，是新包装的，打开就有其他人画在书上的笔记，买的时候也没有看见标注是他人用过的，满心欢喜的等了几天才到的书有别人写的东西心里总感觉怪怪的，很不舒服	negative
亚马逊服务真不错，家里没人，快递很有耐心地联系送货，坚果也是正宗进口的，相当好	positive
为什么跟别的出版社的版本有很多不同之处，人家的版本跟喜马拉雅听书一样，到底是谁对谁错？？？买来教孩子的，这下怎么教，才看了十几页就非常多不同的了	negative
味很大 放了 两天 还是很大 生怕对孩子有影响 满撒气 比想像的严重！ 排水口太小 放水要好长时间	negative
跟着小说中的小主人公从幼儿园到大学毕业，仿佛又经历了一遍青葱岁月，那时的点点滴滴一幕幕回放…每个人都应该拥有属于自己的旧时光，每个人都应该在人生的各个阶段做一些属于这个阶段的事情，比如和小伙伴拉帮结派，比如经受考试的折磨，比如因为优秀而备受瞩目或者因为犯错而被请家长，比如最单纯青涩的恋爱…这样，才不会在老了之后发现回忆是一片空白或者乏味的单调…我也希望我的小孩可以好好去经历一场属于TA的时光，不用一定要多么优秀，但希望可以多彩丰富，可以在步入中年之后，回忆起过去时，带着幸福的微笑说一句：你好，旧时光	positive
还没顾上认真看，总体感觉不错，值得拥有。	positive
商品本身挺好的，但是让我恶心的是鞋子上面粘着疑似从牙缝里扣出来一片的菜叶	negative
不推荐，像实验室里的烧杯。物流丢在门卫就走了，连个电话短信都没有。亚马逊，你这是怎么了。	negative
已经购买了。。皮子相当厚，也不能随意调整角度。。。	negative
保温效果和预期差别太大。试了下焖米，倒是熟了，但是很难吃。另外温度下降后盖子很难打开。	negative
还可以吧，价格便宜，但是和原厂的还是有差距的	positive
书内容很有条理 但书才买来三天，就一直散页！！！！！！！	negative
太差了，生产日期居然是2013年的，促销也不能这样害人的，僵尸果呀	negative
书收到的时候是这样子的，对亚马逊的包装越来越失望，连盒子都没有，快递那么暴力你就一个袋子包过来？袋子还破了。我记得最开始在亚马逊买书都会用盒子装着的，是不是因为那时候我付款的方式是货到付款，而这个是已经先付款了所以这样区别对待？	positive
这本书意外惊喜本来也就是凑单买的 没想到出乎意料的好朋友小书本能够翻开又翻开 启蒙的一些东西也都涉及到了	positive
总的来说还好，只是没有视频有点遗憾，就没有那么生动了	positive
这本书，就是一些所谓的硕士论文的堆砌，出这样的书，有损该出版社的牌子。	negative
要买的得注意尺寸，除了专业人员其实以目前一半的开本就足够。看得很爽，不过书架上不好找地方放啊。	positive
尿完一坨一坨的，跟我之前买的不一样，我觉得不是德国本土的，像是高仿	negative
打开是粉红色的 喝起来也是草莓味的 到底是不是真的？	negative
很轻，脚感还不错。从下单到收货6天时间。	positive
国产的要从国外邮来，高音不错，音质清晰，低音一般，不加功放也就这样了，比天籁原车的音质提高一倍吧	positive
一分都不想给，服务太差了！半个月的时间按客服要求下单5次，都以系统升级为由清关失败退货，期间邮件，电话，在线询问无数次到底是什么问题什么时候能好，先还敷衍两句，推个三五天给回复，最后干脆没有任何回音连敷衍都懒得敷衍了。等了两周没任何消息自己试着再下一单，终于成功，3天就收到了箱子。从第一次下单到最后到手足足一个月。PRIME试用到期就不在这买东西了，真是花钱找罪受，客服都是摆设还不讲信用，说几天给消息的压根没人理	negative
灯亮时很不错，就是关了灯由于灯罩太薄，能看到里面零件黑乎乎一团	negative
电脑上看模特穿着挺漂亮，感觉布料很细腻、柔软，但是拿到手后一看，挺粗糙的，LP说像抹布做的：粗糙、颜色暗淡...。 以后少在这些第三方的店家买东西，不合适退货还得自己另外出15元快递费，虽然是小损失，但费了很多功夫挑选结果还是不合适，伤感情。	negative
店铺买的很软，这家太硬了，太坑了，用两次就漏两次，还是在店铺买好。	negative
没有想象中的好！首先是音响效果很差！还有就是不晓得是卡的问题还是手机的问题！照片好好的就不能看了或者没有了！怪不得这么便宜！一直以为华为的还算不错！没想到会是这样的感觉！	negative
浅显易懂 ，字里行间蕴含着童趣，神秘，坚毅。	positive
腰带质量非常好，盒子挺好看，里面的钱包给弟弟了	positive
初步了解尚可，但细节不足；经验谈多，细致分析论证少。	negative
写的内容很好 翻译已经达到 信 达 雅 的水准！	positive
网购以来最差的一次服务，订单一直没有收到货，打客服打了好多次要退款，每次客服都是推脱说是跟快递核实情况，难道跟快递沟通两个月还没跟核实清楚吗，一直拖着不给解决，以后再也不从亚马逊上买东西了，服务超级差	negative
不错的书，在书中看到了别人不同的生活，但是关于王爷的故事仅限第一章，我是冲着王爷才去买的，有点不爽。	positive
用了的确有一些热热的，而且很滑，感觉很爽，就是接触空气会很快干，加点水就好了。	positive
朋友推荐的，看了扎西的事迹很感动，我喜欢。好评！	positive
挺好吃的白巧克力，就是有点甜了，下次试试看黑巧	positive
虽然不是软件开发人员，但里面的关于个人的建议都值得借鉴参考	positive
盒子是破的，盒子没有用胶带封口，衣服上还有污渍，但孩子都已经跟其它套装混在一起了，只有认了，以后再不再这买娃娃了	negative
总体不错，就是屏幕小 ，显示的字体看不清。	positive
收到中意的手表，好喜欢，包装完美精致，物流速度快，物有所值，卖家售后服务5颗星，下次一定再购买。	positive
包装太差，就一薄薄的朔料纸，拿到之后，朔料纸破了，书也被折坏了，还有书皮也烂了，太TMD差劲了！	negative
材料不错，折叠式很方便收纳。稍微有点偏大。	positive
做工比较粗糙 不大锋利 死皮钳连纸巾都剪不断。。。别说剪别的了。。。	positive
饭盒很喜欢，感觉质量挺好的，很厚实的感觉，但是拿着又轻便。 看起来不大，也挺有容量的，盖子没气味，能轻松打开。O(∩_∩)O哈哈~，喜欢	positive
很快的收到了，一个下午，一杯玫瑰花下午茶，一个杂乱无章的办公桌，一下子清爽无比，下午茶也显得特别惬意了。	positive
造型新颖独特，很好看，淡淡的幽兰色，很喜欢	positive
王阳明的书要慢慢读，细细品，否则消化不了。	positive
东西不知道送哪去了，显示25号到代收点，结果现在还没到	negative
艺术史、故事、甚至八卦全都融合在一起，清晰的艺术史逻辑，生动的艺术家形象，...读起来像读一本引人入胜的小说一样。	positive
运输不负责任，酒都是倒扣着，盒子里酒都听听框框，酒盒子邹邹巴巴，乱七八糟，很是失望。	negative
宝宝不爱看，也不爱玩，反正对于我们没啥用。	positive
没看下去，不是书的问题，而是本事我对这个技术就不感兴趣，当时买这本书也是像要了解下，后来发现，还是去用跨平台的东西，比较靠谱点。	negative
太紧，带的难受，麦克风也不够灵活，洗完买家注意	negative
千万千万千万不要买，我1月17日买的，3月才到，并且还是坏的。办理了退货，一点音讯都没有，已经4月了，连退货信息都被清理掉了，千万千万不要贪图便宜几十块钱，就买了海外的东西	negative
OK的，也是17年的，还没看，不过应该是不错的呢！	positive
此商品说好6月27日送达，到现在还没有到货。	negative
应该给3.5星吧 在高效系列的三部曲中 思考法第一 经营法第二 读书法第三 收获还是有的	positive
包装好，送货快，美中不足，就是打起抽球，球重心不怎稳定，有飘移的现象。	positive
穿着早上跑了一下，感觉还不错。但是尺码小，幸好买了大半码的。鞋前部分、侧部鞋面连接鞋底胶粘并不好，做工粗糙，鞋跟部分倒是做的不错。因为是亚马逊自营的，所以比较放心，总体来说还是不错的，四星好评吧。	positive
价格公道，所以用起来就很爽快了，一下拆了3块，用在不同的地方，硬的地方刷难刷的，软的地方刷容易刷的。不过一分钱一分货，硬的那层薄薄的，估计用不了多久就得换。	positive
适合新手阅读，少走弯路，选择适合自己的投资方向。中国人写的良心之作，语言质朴，逻辑性强。	positive
只谈物流和亚马逊的工作态度，因急用书，邮件催了三次，电话催了三次，下订单后长达96个小时后才发货，也从不主动帮客户提供解决方案，连拆分发货的想法都是我自己想到的，最后还是没有按时用上书，最终送到的时间和我急用的时间差三个小时，有改进余地。315刚过你们就这么张狂，赞	negative
银色也很漂亮，挺闪的，做工精致，朋友也喜欢，又订购了！	positive
和图片不是一个版本的呀，没有鞋头扎的那个线，不过也好看，鞋舌上有小钻，蛮漂亮的，刚好合适，超喜欢	positive
卡扣不紧 一碰就吊 还是需要自己用胶水固定	negative
买的粉色的 非常好看就是浅色真的不禁脏。。。。妹子慎入 另外边框什么的不是特别齐 皮子还算结实 也算对得起这个价格了	positive
1. 它让我忽然想起螺丝刀的刀头原本的样子，也就是关于一点点物理知识的样子。 2. 传说中的磁力，听说过没见过，以前在机箱里找螺丝都得用镊子。	positive
冲着这停留在上世纪九十年代的印刷装帧水平，只好给三星了。想想不忍，于是又多加了一颗星。	positive
书刚刚收到，没有包装，封面脏脏的，书角都磨了，整个一本二手书，怕麻烦，不退了，实在是太让人失望了。	negative
第一次用自动伞，感觉很方便，伞的质量没得说，好。	positive
面料轻、薄，夏天应该户外不错。本人170（60kg），看了前面几位的留言，下单了m码的，结果稍微有点大，凑合着也能穿，只是看起来有点松垮。这才缓过神来，敢情前面几位兄弟都小有发福了。	positive
没有看完，学习是需要坚持，循序渐进的，生活是长途跋涉，不是百米赛跑	negative
羽毛太容易断了，还是小孩的力度。每一只球都是这样。差评	negative
收到书感觉像是旧书，被人翻阅过，没有封膜，书页很松散！	negative
产品买到了，穿着正合适，价格也合适，以后还会购买。	positive
还没看，不过收到时没有包装，边角有磕碰，看起来不像新书。	positive
这个颜色....太难看 不适合学生...还有气味不太喜欢 也容易掉 不过这家店还挺好	negative
店家也太抠门了，，鞋垫，袜子都不得一双，，，唉，，，物流倒是很快。	positive
每课例句和课文，也有翻译。但是翻译得不细致，很多词没有翻译出来，也只有简单的一些语法讲解。 两星给的是课文和例句的实用性。	negative
使用了一下就退货了，没有说明写的超声波功能，描述与实物不符。	negative
亚马逊买东西没有保修。。连保修菜单都没有，而去连反馈菜单都没有。。只能买没保修的产品	negative
1月19日下单，2月6日才收到。既然收到了就不退了。	negative
打开后发现钻都掉了，打电话投诉几次都不给退也不换！让我自己去修补，什么玩意儿啊！十几年购物最恶心的一次！！！！！！！！	negative
不知道是不是正品，现在没用了，长粉刺，而且没有包装，标签是歪的	negative
这书非常好，跟扎实，很全面，是准备公考的好帮手。	negative
含酒精。闻起来有点冲，喷到身上很凉爽，比较细腻，防水效果还可以，就是没有那么清爽，但是也不会搓泥，还不错，身上用喷雾方便很多	positive
结合并购之王，让你在最短的时间内，了解金融帝国的真实面貌！	positive
新商品拆开包装后味道较大，需要放置一段时间才行。安全座椅不能调节角度，有点遗憾，其他都挺好的	positive
外观还可，其实直接用硬盘加一个硬盘盒就可以搞定了，单买移动硬盘多100块钱	positive
好后悔买这本书，对我完全没帮助，又贵。。。	negative
宝贝很漂亮，穿上正好合适，面料不错，做工很好，朋友都觉得这个价格很值。	positive
理由和《宏观经济学》那本书相同。拿到书后，脏且皱，甚是后悔。	negative
亚马逊5年的客户，从来没有写过评论。因为这个产品的功能与产品实际功效严重不符。上当受骗了，骗子。	negative
好看啊，质量也很好，也没有怪味。与KINDLE完美的契合在一起。赞。	positive
之前也买过，用的很好，但是这次的牙线拉出极其费劲，牙线这么细，不好发力，女性估计都拉不出来。 不该买最后剩下来的尾货	negative
书中许多地方印证了我的想法。一个女人的优雅，绝不是偶然。	positive
换了第三方物流以后感觉明显不太给力了，同样订的一套书，某东一天就到了，这里三天还无故延误了一天。希望要改进吧，每年那么多的免费，连物流也支撑不起来	positive
想说的是质量，翻开一页胶就脱了。。。。。	negative
"鞋子还凑活，毕竟价格在这里摆着，但是尺码真是小啊，我平时穿43，这款44都不行，真是无语O__O""…"	negative
翻译水平如此之烂令人吃惊，读起来如同嚼蜡，实在看不下去，连基本的注解都没有！ 审核的编辑是水平太差，还是不负责任？这种质量的书也能出版？！建议下架！！！	negative
今天刚开，为什么里面没有勺子呢。这点很可疑，希望吃了不要出什么事	negative
不是很好用，保湿效果不好 ，很多气泡，不值这个价格	negative
感觉要求每次吃的量有点大。 前期增重明显，训练和增肌粉结合，半个月可以增重1公斤多。 停止使用之后，体重迅速下降，恢复到之前的水平。 总体来说，如果持续使用的话，应该可以保持。	positive
一篇大概是1分钟左右，最长没有超过1分15秒的，一共120篇，全部能够听得懂的话估计也很NB了	positive
质量不错，使用起来挺方便的，缺点是每次装取稍有些麻烦	positive
握力器刚买回来，就握了几下就坏了。拉力器也不是很好。一开始以为虽然差点就行，但没想到差的恁很。无语了	negative
太垃圾了吧，网上已经有了80%，后面20%就是闲扯...连5块也不值，我要退货	negative
自带音乐很好听。现在的华为总体性能比以前好多了，不过价位也好高。第一次买华为手机，带着无所谓的态度试试，结果还好，有很多惊喜。照相效果也很不错。	positive
帮朋友买的，朋友说，味道还可以，但是，饼干盒子直接装在一个空旷的纸箱里，没有任何缓冲，打开一看，几乎已经碎完了，根本没办法拿出来招待客人	negative
包包让人太惊喜了，非常喜欢，包包质量很好，颜色也很漂亮，款式大方，同事好几个见了也很喜欢	positive
我减肥有2个月了，最开始的体重210斤，头一个月效果很快，但是当减肥到第二个月，体重195的时候就陷入了瓶颈期，如何运动都无法减重。在朋友的推荐下开始吃左旋肉碱，减肥第6周目前体重188斤。感觉效果很不错。但是晚上容易兴奋失眠。不知道别人有没有这种情况。	positive
40码对我来说是大了点点，要是有39.5码的就完美了！	positive
送货来时书是塑封包装了的，干净的书，感觉很好。	negative
发来的时候根本没有无线接收器，只能用蓝牙连接。光标速度慢，每次开始使用要反应一会才会动	negative
浓浓的豆瓣风。对于长期混豆瓣和知乎的人来说，对这本书实在是无感。以上个人观点。	negative
看到东西就直接申请退货了，这东西也不知道到底积压了多少年。	negative
整体性能很不错，自带的东西有点多，自己删了也没影响用，运行流畅，满意。	positive
奶粉替家人代购的，还没有品尝……物流和包装都没问题。	positive
很好塑形。快硬了放点水捏捏，又可以用了。	positive
看了之后会有很大的帮助，让你节省很多时间，不用整天泡在论坛里潜水，而且很详细，每一个步骤，都有详细说明！	positive
我的出风口是上下移动的，不好插，手机经常掉下来。评三星	negative
这款的手表有没有表带我买这款的表带坏了，请问你们买不买	negative
发货无比慢，物流无比慢，糟糕的亚马逊购物	negative
泰国产 用着还不错 买日亚的完全不用担心磕碰 包装很好	positive
物有所值，这个价格能买到这种质量的箱子已经非常不错了~	positive
给宝宝囤货中，不过购买的花纹与送到的花纹不一样	positive
对面对女孩陌生的男人很具有指导作用，书中搭讪的开场白，很容易学到，但真正的交流还需要书外去实战，去领会。	positive
第三次用完竟然上下盖就锁不住了，什么质量呀。 放了一个多月竟然能盖住了，但问题又来了，煮粥时经常喷出，火候很小了，竟然还会喷的到处都是，郁闷坏了，喷的到处是。这种情况好几次了，都很小的火了还是会喷，突然压力锅ci ci ci 响，然后就从喷气处将锅内的东西往出喷	negative
是我想要的颜色 运行速度还可以 下载比较快 但是浏览网页久了 电板有点发热 其他功能待测试	positive
说好的穿线呢？怎么没有，现在描述里面也修改了？早知道没上好线就不要了。并且是自营吗？怎么总是在修改，开始显示自营，后面修改成成都什么体育，现在又是自营？	negative
拿到手兴致勃勃地拆开 一翻开封面就掉了 之前看评论说意大利印刷的是线装 花了一百多块买回来 结果依然是胶装 根本不值这个价	negative
很喜欢这本书哦~ 因为书的纸张、封面、排版都很nice，让人看着很舒服，故事内容很暖心，推荐喜欢看书的朋友购买哦。 不怕对自己的现状不满，也不要觉得很多事情都已经来不及，即便是过往你舍不下离不开的人和事。 你永远都有时间从头再来，你要相信，所有失去的都会以另一种方式归来。	positive
口感还可以，但是包装很不好，很多罐子都变形了，不知道是运输的问题还是其它原因？	negative
翻译出现大量低级翻译，建议大家千万别买！	negative
没有丝毫用处，总结的不全面，而且大部分都是由特定的例子来衬托自己说话的准确性，翻了五分钟就扔了	negative
因为它是我第一次在亚马逊购买，物流送得快，可是发货比较慢，希望下次改进！	positive
有点旧旧的感觉，有的字迹不是特别的清晰，纸张也不是很好。	negative
配件不齐，只有一根琴弦，而且音不是很好，包裹有中途打开的痕迹，用了没多久都断了，而且上面还没卖的	negative
很不错，可以购买，但是不好洗，做好心理准备吧。	positive
不知道是不是运输的问题，整个帽子都是偏的，帽檐也不对称，心累，难道要自己用手掰回去么	negative
不废话，用料很垃圾，两天就掉皮了。但是，反正两面用的理念倒是很好。	negative
非常一般，无论是纸质还是内容，也有不少错误，但是其他书更差劲，你懂得！	negative
年前买的中途邮丢一次，重新拍的亚马逊给补的差价还补偿了邮费，客服联系及时服务到位，好评给亚马逊。另外，衣服质量真棒，美国产的。174穿M码正好，上身效果跟图片一样，袖子在手腕和虎口偏上，衣襟在腰带附近。	positive
哈哈哈哈哈哈哈哈哈哈哈哈哈哈哈哈哈哈哈哈哈哈哈哈	negative
其中一个哑铃紧箍卡扣是坏的！开模有问题螺纹是歪的！这个运气问题吧 连接长杆不算影响适用 但是服务态度就值得怀疑了～	negative
用了几天才评手机非常不错，很流畅。就是电池不耐用。指纹比mate7好评。	positive
第一次给一本书评价，隔壁的人人都是。。。那本书比这一本好很多。这本书中很多都是作者的一面之词，语气十分夸大。差评	negative
第一本写的真的很好 学校中两人的故事 包括一些其它的经历 但因为妹妹去世哥哥就与世隔绝 少点说明的东西 第二本写的个人感觉略乱 彩蛋很甜啊	positive
光泽度比较好。送了一组皮筋和一包钢珠子。收到的时候包装有点压坏了。 正好51可以玩的时候可以用。亚马逊的送货速度确实是超给力。	positive
下胸围太松，同码不同款这个没法穿，胸垫严重跑偏，退货了，售后很不错的	negative
收到货，全新。查了序列号，未激活。犹豫好几天，目前看还不错！	positive
使用第二天就出现启动不了的情况，体验度太差	negative
龙井茶是我的最爱，这个不是太给力，不过还行，叶子比较大，口感一般，有点涩，龙井都不耐泡，3泡到头。	positive
东西很好，可惜就是买完香港就有货了，有点心塞！！！	positive
差评，首先牙膏太假，都没封口，第二，我买了6个，你给我发的时期都是17年2月份到期的，大哥现在都12月中旬了，你让我吃啊！！！！第一次用亚马逊，认栽了，估计不会再有以后了	negative
价格非常实惠，鞋子的品质和价格匹配，一分价格一分货。	positive
版型比较宽厚，很防寒，防寒功能是最主要的吧。说实话倒是不怎么好看。衣服和图片差不多。180cm，155斤，M码刚刚好	positive
这个版本的翻译一言难尽，而且，当当网只卖14	negative
保温性能好，12小时还是温的，就是盖子里的水蒸气较多，用了一段时间盖子有点漏水了，放家里当保温瓶用了。	positive
还没怎么带，下个雨就进水了。太差了，还一百多块呢。	negative
快递真乃神速 一天就到货 唯一不足的事 水晶耳套 带着不习惯	positive
这本书一买来就脱胶了～～～现在才想起来评论	negative
东西还不错，购买过程比较波折，换货耗了几天。安装耗时一整天。	positive
还行吧，但是国产的和原装进口的有区别，吸管有轻微的气味。	positive
非常不错的一款短袖。样式挺好看，和描述一致弹性也比较好！赞一个	positive
电子书封面是否可以更新上去？没封面感觉很不爽！	negative
解忧杂货店那本书边角有点被压到，有些褶皱。	positive
翻译得莫名其妙 感觉就是生硬而不负责的直译 好些地方不知所云 两位译者还是不要兼职翻译了 总的来说 是我买过的翻得最差的一本书……	negative
思路很棒 值得通读 只是举例中有很多习语过于老旧酸腐 英国人都不会用 所以不必背	positive
大小合适，稍微有点压脚背，重要的是她很喜欢！	positive
老板 我买回来怎么没有地址也没有电话 有什么问题怎么联系你们	negative
东西很好，只是软管短了几公分； 快递超慢，双倍时间！	positive
没有达到宣称的速度，写入速度80MB/S	negative
1、第一次送到的，电话卡槽不能识别； 2、出现问题，更换的速度很快； 3、反应速度还可以	positive
一直想读都没有读，最近终于入手，很棒是正版！包装很好	positive
尺码发错了，发的是UK7.5，因为外出回来己关闭了退换货通道，发了电邮也不回复真不知道你们是咋做的售后	negative
感觉真的是什么人都在写书 没什么内涵 不适合放在书架上反复翻阅	negative
蓝色的钻上有明显的一条口子，很长很深，也不知道是为什么，没有保修卡和证书，感觉不是正品	negative
还是不错的，值得一读！心平气和地表达自己的需求。表达，是要学习的。	positive
杯子看起来有点长，不过毕竟是600毫升的。	positive
该书从结构体例到内容质量，皆堪称精品！本书的作者都直接参与了司法解释的起草，不仅揭示司法解释条文起草时的各种观点之争及最终立场选择的深层考虑，还就立法现状及存在问题、理论基础及法理分析、境外立法例的比较展开深入分析，而且在此基础上就司法解释条文适用时应当注意的问题给与了清晰的解读！总之，兼具理论性与实践性，是一本权威、全面、深刻、实用的难得的保险法领域的书籍，很值得推荐！	positive
衣服不错，穿着时尚修身 高档面料 质量超值	positive
收到了5个，分给舍友吃了，都说甜甜的，有水果的香味。值得一提，比在淘宝上购买要划算许多。比如我在武汉，在淘宝上就必须满300才能包邮，但是在亚马逊上只需要满100.火龙果和苹果都比淘宝上便宜。到货速度也快。	positive
170cm70kg大了，但材质可以，多打几个眼吧	positive
是生姜洗面奶，冬天试用了一下，还算可以，有时会有洗得不够干净的感觉，要洗两次	positive
短篇小说，写的很好，也没什么坑，是能一口气读完的好书	positive
不推荐此书。文字太刻意，作为科幻作品太过牵强，读到一半就读不下去了	negative
买的平装的，可是纸质太差了，38元买这种纸质，不满意啊	negative
理论部分讲得到还可以，但是例题中的错误太多无法忍受，而且没有勘误！ 如果不注意就被绕进去了，完全是误人子弟！ 比如图中这题明明应该选B，这里答案竟然给的D，简直坑爹！	negative
很好 是正品 质量不错 内容一般	positive
纸质真的太差，对于喜欢看纸质一定不要贪图便宜，会让你有种不想看下去，或者收藏的任何动力	negative
215中国码贝壳偏大，我女儿225的脚正好还有点余量正好舒服。	positive
敢在活动的时候买的 ，性价比很高，而且鞋子穿着很舒服，是正品。	positive
骗子！再也不在亚马逊买东西了，太不靠谱了！买的时候显示是32Ｇ，买回来却是8Ｇ。之前看了评论说上当还不明白，这次自己明白了！！大家别上当！	negative
上周日下的订单，周四还没到货，急着用的，这是乌龟的速度吗？真是低效率！退货！！！	negative
其他很好，就是装订很差，孩子还没翻看完就散架！	positive
书厚薄比想象中的薄很多，好在内容比较适合对大画幅完全不了解的外行入个门还不错，如果想系统的学习一下，需要买更专业一点的书！	positive
手表四星，总体挺好。手表沉稳、大气，年轻人带着显得太过成熟；表链感觉一般。亚马逊服务五星，先前看上的是另一款手表，收到货后不喜欢就申请退货了，退货很快捷，服务很好。	positive
抱着满心期待的买下这本书，等待许久都没有到货，今天一查竟然退货了，能给个不能到的理由吗？	negative
还没具体看，看看文笔来说就很中国官方老套的口气。跟彼得蒂尔的封面这么像也是醉了，就这一点就搞得我买错了书	negative
材质很好，穿起来也很好看，很满意的一次交易，还会再来的。	positive
这种书籍没必要精装！浪费资源！还贵！ 而且开卷八分钟的音频免费、比这书还精彩！	negative
翻译的很好，看了之后想起来legal high里面的一集了。主人公的个性不太喜欢，不过也是作者特意的安排吧。	positive
商品没有任何问题，非常好。相信亚马逊。建议：完善手机APP，因为京东的APP比亚马逊的好用。	positive
挺喜欢的老婆，做豆浆做料理奶昔，都棒棒的，不错	positive
玩具很好，比国内便宜一半～亚马逊Prime真心赞，8天就从美国运过来了，省了不少运费	positive
10月份买的，到现在才7个多月就坏了！也不知到哪找售后！！	negative
收到货以后 一看 什么玩意26英寸变27, 14英寸变15 以后再也不在这里买了	negative
还没用，看说明还不错。 快递和卖相给力。	positive
之前海淘了个同系列的邮差包，美亚。。。五金件有点痕迹，所以有可能还是想中亚买。 做工真心好，外形也比TUMI看着顺眼多了，很喜欢。	positive
感觉花洒开关那里控制得不好，容易漏水，也不知道是不是货的问题还是本身就是这样	negative
错别字太多！错别字太多！错别字太多！完全颠覆了我对kindle的好感，这简直是对金庸先生的最大不尊重！是什么人负责编辑的？建议开除吧。	negative
鞋子很轻，非常舒适，特别适合穿不了高跟鞋的我，哈哈。	positive
写入1MB 读取2MB 这么慢 坑谁呢。	negative
衣服收到了，非常漂亮，很时尚，穿质量也非常好，没有色差料子非常舒服	positive
这个牌子的线这是第二次买了，质量真是一般，之前以为是自己的使用问题，摔了一下坏掉了；后来又买了一次，结果三根两根不认证，这质量也是没说的了。	negative
郁闷的一次购物，书是破的。寄得时候没有外包装。	negative
内页纸每张都能看到背面的字，我几乎要怀疑是不是正版了。 当然书的内容我还是非常喜欢的！	negative
这个东西有点坑，原来的血压仪就卖300了，充电器还要另买，50	negative
没看到实物家人签收的。 囤货、宝宝要过两个月才吃这种。在亚马逊买宝宝食品真是要拼人品的，这次日期不错	positive
大家买时记得买大一号，质量很好，值得购买。	positive
耳机挺不错的，对于要求不是很高的人就完全足够了。	positive
1.运动是为了获得充沛的精力； 2.养成健康的生活习惯，会让你获得精神劲十足； 3.深度睡眠，健康饮食，规律运动，系统工程，全面掌控。	positive
小朋友学校规定的阅读书目，书本未发现破损。	positive
这款手电筒不错 和产品描述的一样 价格也不贵	positive
物流很快，书质量很好，就是我的发票没有给我	positive
与“不出糗!用餐的优雅”一样，看你是国民们不太在意的方面，希望每个人都读一读，提高自己的素养哦！推荐！	positive
1 设计者一定有问题，出风口不可调方向，非常容易掉，一拿水箱就掉 2 出风口设计不合理，容易进水，报废比例非常高 3 咨询当地维修根部不给修这款，废物款，而且网络买的不修 特别注意：：亚马逊的配送人员不知道是品质问题还是工作能力问题，该物品退后，被配送人员取走，然后竟然在网站进度上显示客户取消退件。天哪，拿走就说是客户取消，那这个物件岂不是自己贪了，也许以为这个很值钱？？？希望只是能力问题不是品质问题，已经递交亚马逊客户，看看如何处置，亚马逊是否可以接着信任。另外第二天购买的Kasrrow 凯仕乐 KSR-18 颈肩乐颈部按摩器收到后就退了，按钮不能用，没有液晶屏，不知道亚马逊怎么了，完全成了垃圾处理平台，别的电商突飞猛进，亚马逊取自掘坟墓，几年以上的老客户都不敢信任亚马逊了。	negative
很好，佩服作者，似乎历史、经济、政治各方面懂得都很多。	positive
昨晚9点拍的669元，今早就变549元了，太坑了，东西是好的，但亚马逊	positive
麻烦亚马逊客服告知手机自带软件有哪些 为什么会有那么软件在里面 是不是二手机	negative
還行,符合預期, 看起來質量不錯, 小孩喜歡.	positive
app模式下还不错，可以操控行走，也可以玩各种表情。	positive
收到的碗还是不错的，闻着没有任何气味。我收到的这个包装里面有3个碗，比介绍里的多出一个。不知是介绍信息有问题，还是换包装了。	positive
国产的，标注的尺码有一点点偏小，178穿180/96A有点贴身。	negative
耳机的线条摸起来是挺舒服的，入耳式戴起来的感觉也是不错的。	positive
收到货了，衣服质量还不错，没什么色差，偏薄，比较适合夏天穿，凉快，考虑要不要再买一件白色的。	positive
帮朋友买的 很快 过年的时候 还是隔天到	positive
快递很快，书是全新的，而且包装的很好，很不错的一次购物体验。	positive
快递包装真的是一层纸，也是醉了，发过来的书被蹭了一块	positive
我家喵貌似不太喜欢吃这个，另外吃了这个之后便便的味道实在太大了； 怀疑这个猫粮的盐分有点大，吃了这个后喵喝水比以前多多了。	positive
比电视剧精彩太多，作者肯定是饱经世事，深谙人情的人，书中的人情世故，你来我往，让我这个不谙世事人情的人受益匪浅！完全可以当做提高情商的教科书来看！而且文笔时而优美时而活泼，情节紧凑，逻辑清晰，扣人心弦！值得一看！	positive
书写的很实在，在市面上很难看到SAP在设备维修方面的书，开卷有益。	positive
很好的体现了文艺复兴时期人的理性精神，不过由于理性精神过度膨胀，导致人与传统伦理彻底决裂	positive
还行吧，帮姐姐买的，但是姐姐反馈说有的书页颜色不一样哦，不过能接受，四星吧。	positive
网上买袜子最好的一次，质量很好，非常适合穿运动鞋	positive
很厚实的裤子，直筒的库管很大。适合体型壮实的，不适合亚洲人身形	positive
从图书馆里借了手把手系列的其中一本书，所以看完觉得到这里网购一些！	positive
好书收藏参考了好书收藏参考了，很喜欢，很有帮助。	positive
挺贵的。博客文章集锦的即视感。凑单买的，后悔了。	negative
里面有8张白纸，第7页到22页都是空白的，之前没发现，现在备考这一科才拿出来看，哎.....	negative
下次发货检查一下好嘛，字典前面那个磕坏了，而且版本12年，太旧了,	positive
讲的是企业在互联网经济时代的转型，以企业接班人的角度运用小说的形式，把管理的内容诠释的非常到位，文笔也很不错，推荐。	positive
特别好看,剧情不错,推荐。是看完了还像再看的,反复阅读的书	positive
鼎鼎大名的育儿书，因为前后买过七八本育儿书，个人认为这本和崔那本很一般，内容配不上价格，对具体问题只有简略的提及，没有详细的介绍和应对方法，不如育儿百科。不建议购买	negative
非常好，大品牌，质量好，做工好！亚马逊的服务更好！	positive
比较实用，不过一般人没这些时间去监工啊 ！	positive
丧心病狂的“订购省”，诸位一定要小心！！	negative
有很多重复的内容和图片，一般，配送也有问题，穿整个成都市去自取的	negative
1 作为科普书籍，可以值得5星； 2 网络离散碎片内容集合体； 3 作者有自己的一套时间线阐述逻辑； 4 给一星是因为花钱买了一本内容讲的比较浅的书籍，这也没办法，毕竟涉及内容太多了； 5 快速看完之后，自我认知层面顶多增加自己名词解释而已；	negative
很精致，物有所值，回来的时候时间和日期都已经调好了，很贴心！正在研究纯英文的说明书！中国组装的。	positive
书一看就是盗版的，目录与英文缩写部分之间却少六七页，真是醉了，而且里面内容有些语句都念不通，买的后悔	negative
使用后和之前使用的相同产品不一样！质疑真伪	negative
使用很方便，可惜没有坐垫，冬天只好在里面垫个毛巾。感觉有点小，宝宝大点估计就用不了了，卡扣有时候很不好拆，不知道多拆几次会不会断掉。	positive
1. 书没有塑封,拿到的时候切边全是污渍, 换了一本也好不到哪里去,所以选了本稍微不那么脏的; 2. 纸张质量一塌糊涂, 灰色的纸+油墨味, 跟盗版一样 介意这些的要慎重,当然不针对书的内容	negative
里面彩图比较多 ，但是觉得有些地方不是很通顺，总之是有点顺着读者的一本书。	positive
用了3个月了，刚开始好好的，第二个月开始老掉线，在房间里3米内也经常没有信号，用着心烦！	negative
虽然全彩 但是里面东西质量一般般，根本不值这个价，书当然是好书。	negative
我了解这本书是从微信订阅号十点读书里面，然后就打算买来看看，结果真的觉得非常狗血，不管是故事情节还是写作水平。苏之微确实努力，她可以说是千千万万个毕业生里面的一个，放在人海里面，可能谁都不会认识，就是这样的一个女孩子从菜鸟到天鹅的华丽转身，确实要付出努力，我欣赏她的个性。可是，官二代，富二代的爱上，这样的故事情节真的他狗血了，就像老掉牙的为了博得观众眼球的戏码，文章大量的使用奢侈品，这样的设置总是给人一种虚荣的感觉，奢侈品这种东西针对的毕竟是少数人，在中国，在这个世界上，有多少人是不可能达到奢侈品的级别的。这样的肤浅作品是我不欣赏的，缺少心灵的感觉，虽然励志，可是很空。	negative
物流过慢，质量差，书中很多页均出现油印，且个别页出现无字。	negative
从字里行间能看出这是一本诚信之作 就是推荐的护肤品颇贵 并买不起	positive
质量可以。应该正品。洗衣干干净净的感觉。香味清淡些了。不怎么香的感觉。	positive
为什么买了没多久就降价，甚至淘宝旗舰店现在这款只要799	negative
很轻，没异味，只有大写字母。希望也有小写字母。	positive
这本书还是很不错的，初学者可以看看，有助于编写出优美的代码来	positive
太薄了，跟纸一样关键洗完拧干的时候感觉分分钟就会拧破一样，这是ua贴牌的吧，好在便宜。。。。马来产的	negative
非洲三万里，听作者诉说旅游故事，走在路上，亲身体验别人说的对不对，历史，文化，政治，经济等都融入到旅行中来。	positive
