text	label
Está aceptable, pero al subirme bambolea un poco. No cómo para que me pueda caer, pero tampoco es super estable.	positive
Es un poco grande, pero está bien. Podría ser más grande el espacio para poner el estropajo.	positive
Lo mejor la simplicidad de dejarlos en la base de carga inalámbrica de mi mesilla y tenerlos cargados sin tener que enchufarlos.	positive
muy mal porque pedi otra cosa.	negative
Una funda dura pero ligera a la vez, se la ve robusta y encaja perfectamente en mi Samsung galaxy note 8	positive
pedí tres bolsas de 50 , me vienen dos y unas pegatinas que yo no he pedido, me han tomado el pelo pero bien......	negative
Huelen suficiente y bien, son bonitas y buenas.	positive
Perfecto corta muy bien no esportilla	positive
Pésimo producto todo plástico frágil Solo le he podido utilizar dos veces Dinero tirado a la basura. La goma por la que pasa la cerveza rota muy frágil.	negative
Venía más pequeño de lo esperado. Aún así los regalé y el que los lleva dice que está encantado y que son muy cómodos. Pongo dos estrella por qué la talla no corresponde.	negative
Realmente afea bastante el reloj, además que de no está conseguido el asunto de las aristas (bordes redondos del apple watch), por lo que no es recomendable. Si tienes un apple con pantalla de zafiro olvídate de estos accesorios. No obstante el envío fue super rápido, buena presentación y ninguna queja en ese sentido.	negative
No es original. No es de carga rapida. Todo es una mentira todo que esta escrito en anuncio. Muy mal.	negative
Es genial, imprime muy bien	positive
No ha llegado pero si me lo han cobrado. Espero que llegue antes de que cambie de móvil. Llevo una semana esperando	negative
Es un libro que se lee rápidamente y que da bastante buenos consejos respecto a trucos y tips básicos de maquillaje. No está de más tenerlo para consultar de vez en cuando.	positive
Muy mal “profesional” por decir algo el que me trajo el producto y se las gastó como veis en las fotos. Casi rompo mi buzón,y casi se rompe el producto. Amazon no debería trabajar con gente así.	negative
El producto nunga llegó, después de un mes esperándolo ,en ningún momento me han comunicado ni he podido ver la situación del envío solo que lo habían enviado.	negative
Objetivo de gran calidad a un precio ajustado; ideal para llevarlo de viaje debido a su amplio rango focal, que permite hacer desde paisajes hasta retratos.	positive
Le cuesta sincronizarse con el móvil y no funciona todos los botones del mando. Depende como hace fotos en continuo sin parar.	negative
No termina de convencerme porque arruga la ropa. Puede que no lo utilice bien	positive
Se sale la tablet de 10'1 pulgadas. Creo que sería mejor para otras de mayor tamaño. Se dobla perfectamente, eso sí, pero cuesta que esté fija con el sistema de gomas elásticas.	negative
Carga bien de momento se notan los 5000 mah La recomiendo pero sinceramente no es vuestra funda si pretendéis llevarla en un bolsillo. Es muy tocha y pesa mucho.	positive
El toner dura poco , y la impresión es muy mala, desde muy pronto	negative
Es agradable al tacto pero tiene un punto pringoso que dejar con solo rozar la Comisura de los labios. Está bien pero lo comentaría porque resulta muy untuosa	negative
Nunca me llego desde el 24 de mayo que me dice que viene con retraso y el vendedor jamás me devolvió los mensajes muy mal puntuación 0	negative
Es tan sencillo que lo he tenido que tirar porque ya las palomillas están rotas la barra no aguanta lo suficiente y cuando lo quieres montar se dobla del medio	negative
Consume la pila enseguida, no me gustó nada, es poco preciso para trabajar con programas de diseño o dibujo como autocad o photoshop.	negative
Tal y como aparece,buen tacto y muy sexy...para todas las tallas pues es muy elástico	positive
Es ideal pero hay que ser constante. Los velcros funcionan muy bien y son dobles de manera que sujeta toda la cintura.	positive
Ideal para mi hija de dos años. No es muy grande, lo que va muy bien en un piso más bien pequeño. Colores bonitos tanto para niño como para niña. Accesorios también de madera muy bonitos. Buenos acabados. Más bonita y ecológica que las de plástico	positive
La picadora está muy bien! Hacia ya un rato estaba pensando en comprarla, hasta que me animé hacerlo y me ha encantado. Puedo hacer fácil y rápidamente mis propias hamburguesas de carne, pollo o pavo sabiendo exactamente que contienen!!!	positive
Se ensucia del roce, y es imposible quitarlo. No es nada útil la parte blanca, por muy mona que sea. Yo no la compraba de nuevo ni de broma.	negative
Me ha gustado todo, es una colonia muy especial	positive
La ventosa no pega bien y se resbala en la ducha, que era para donde lo quería poner. Mi huawei p10 lite no consigue conectar. Él samsung de mi hija conectó a la primera. Le funcionaba bien, pero una vez que cayó al suelo de la ducha ya no ha vuelto a oírse bien. Una pena.	negative
Se que el producto por el precio que tiene no le puedo pedir mucho, pero un simple volumen para que la música fantástica ! que toca mi hijo de 2 años no suene tan FUERTE. Tiene solo volumen para la radio lo que no sirve de nada ya que no la pone mucho. Y no se puede tocar dos notas al mismo tiempo.	negative
Parece que hayan rellenado el bote con otro producto. El bote está todo rallado y desgastado. No me fío que sea el original	negative
Perfecto , es lo que esperaba	positive
Con un uso medio diario de una hora se han fundido en dos meses.Muy malas	negative
Me ha llegado defectuoso me sabe a quemado tengo 2 años en el mundo del vapeo y este me ha llegado defectuoso	negative
Tiene muchas cosas. Algunas serán útiles, otras no tanto. La calidad es suficiente, pero no excelente. Es muy compacto y queda todo muy recogido. Para sacarte de un apuro, puede valer.	positive
Me quito un atasco que con otros no podía. Tiene mucha potencia y se amolda tanto a lavabos como al váter.	positive
No era lo que esperaba	negative
Perfecto para decorar el árbol	positive
pensaba que iba a ser la leche y la verdad que no es que se diga muy efectivo... donde estén las pinzas y los apratos de toda la vida manuales que se quite esto. Si tenéis otros productos no eléctrico sno lo compréis porque no os va a servir de nada, yo recomiendo los extractores manuales que se venden por ahí antes que esto sin duda	negative
Me llegó en menos de 24 horas. El aparato mucho más barato que en otros sitios y con la misma función. Llevo usándolo solo tres días, pero noto fenomenal la piel por la mañana.	positive
Llego antes de lo previsto	positive
El botón para abrirlo venía encallado y no hay manera de abrirlo por donde toca.	negative
A mi me va muy bien llevo usándolo tiempo	positive
Los materiales son flojos, es barato y se nota. Su Funcionamiento es correcto y se ve la pantalla bien, es manejable de forma intuitiva.	negative
Creo que si tienes más de un gato lo utilizarán más , se esconden, saltan ...	positive
Muy buena relación calidad precio. El pulsometro no es demasiado exacto, mejora su precisión a altas pulsaciones, pero en general muy contento con el reloj. Lo tengo desde hace 6 meses y no he tenido ningún problema. Lo mejor el gps, cuando salgo a correr registra todo perfectamente, altitud, distancia, velocidad...	positive
Si calienta bien.....pero no es estanco....no es hermetico....gotea por donde los cubiertos .....se supone que no debería perder líquido	negative
Las he comprado para colgar bicis talla L y si recomiendo no utilizar los tornillos que traen y poner unos buenos tacos y buenos tornillos, porque las bicis pesan. Pero estoy contento con el producto ya que se ve bueno y robusto	positive
El olor a pintura es muy fuerte. La tengo que dejar fuera en la terraza a que se airee a ver si así se le va. Respecto al diseño está bien. Otro punto en contra es que el color de la máscara no es blanco 100% sino que tiene como un toque amarillento... No sé si es así de fábrica o es que me ha tocado una defectuosa. La máscara es más cara que la calidad del producto.	negative
Fácil manejo y práctico a corta distancia.	positive
La figura en si es muy buena. El problema es el embalaje utilizado para el envío del producto. Lógicamente habrá recibido golpes durante el transporte y la caja ha venido dañada. Siendo un producto de coleccionismo es inaceptable.	negative
Como la descripcion, sin problemas	positive
La parte de arriba no queda bien	negative
Recomendable. Encaja perfecto en el Ibiza 6l	positive
No puedo decir si cumple con las espectativas o no, porque lo compré y no me llegó nunca. Estoy esperando soluciones.	negative
Para dar una opinión sobre este producto deberia al menos esperar un mes, solo puedo basarme en que los niños lo toman muy contentos porque el sabor les gusta y el formato en pastilla me resulta fácil a la hora de dárselo, pero si son o no son efectivos creo que tengo que esperar	positive
Monedero pequeño, pero muy práctico cuando el bolso también es pequeño. Elegante, color muy bonito y sin fallos en las costuras. Duradero	positive
Precio elevado para su calidad. No lo volvería a comprar	negative
A veces se inicia sola una actividad y cuando te das cuenta lleva iniciada minutos o incluso horas.Los pasos se los inventa ya que fregando los platos o conduciendo ya te dice que estás andando.La frecuencia cardíaca a veces creo que también se la inventa.Lo tengo como un reloj normal acuático...no creo que sirva para más	negative
Bastante bien en calidad y precio	positive
Lo mejor la duración de la batería mas de una semana muy cómodo para hacer deporte, facil de usar y	positive
Cumple con lo descrito	positive
Son cuadrados pequeños, no un rollo	negative
Es mucho más pequeña que una espátula normal, parece de juguete.	negative
No cubre la totalidad de la pantalla. Le faltan milímetros de protector por cada lado.	negative
Carga rápida. Bien. Recomendable	positive
"Para el precio y el tamaño, no se puede esperar que tenga ninguna ""super succión"", pero cumple con lo deseado. Limpia bien migas y suciedad facil de recoger. Yo lo utilizo para limpiar la suciedad que dejan mis dos periquitos, y para eso me va genial."	positive
Todo perfecto ,las he utilizado con anterioridad y quede contento por su comodidad, dureza,y agarre.	positive
Se me han roto en un minuto se rompe el plástico negro por dónde salen las escobilla ,la unión entre la madera y el plástico , pésimas no las recomiendo .	negative
Muy bien construido, buen tacto y estetico, buena compra.	positive
Tirado el dinero no pega en ningun lado para tv no vale, luces correctas pero inservible solo añadiendo fixo pegas eso	negative
Pense era otra cosa la verdad ni la usa	negative
"Lo he utilizado para una televisión de 65"" aguanta perfectamente, incluso cambiando la altura se mantiene sin problemas. La base es muy estable, no balancea en ningún momento."	positive
E pedido este producto para un regalo y me a llegado sin ocultar el producto lo recibió la persona para la que Hera el regalo estoy indignado esto es de vergüenza no lo devuelvo por qué no me da tiempo a comprar otro regalo espero que esto no le vuelva a ocurrir a otra persona estoy es de vergüenza con toda la reputación que tiene Amazon	negative
Una maravilla relación calidad precio no tiene rival	positive
Pedí el producto hace mas de 2 meses y aún no recibí nada. No lo recomiendo	negative
Malísimas. Muy mala calidad de las cerraduras, se rompen con solo mirarlas, muy endebles. He devuelto las primeras que compré el mismo día que las instalé, las segundas igual de malas...las devolveré también.	negative
Por ahora es la primera vez que la utilizo y no puedo decir mas pero de textura muy buena y olor perfecto	positive
Es acolchadita y de buena calidad. Ideal para proteger la flauta. Además tiene un lugar para poner el nombre de mi hijo.	positive
La correa en sí está bien, pero el mosquetón de la cuerda de seguridad es una autentica porquería. Se ha roto antes de sacarlo a la calle. El cierre no hace presión y se queda semiabierto. Además no es el que ponen en la foto, no lleva rosca para cerrarlo. He tenido que comprar otro mosquetón para poder estrenar la correa.	negative
Funciona a las mil maravillas. Nada más encenderlo ya comienza a crear una columna de humedad que reparte el olor del aceite por casi toda la casa. Se puede programar por horas y además se apaga si se acaba el agua. El cambio de colores es muy agradable y es totalmente silencioso. Muy contento con la compra.	positive
Muy recomendable! Mi bebe iba incomodo en la sillita del coche y sudaba mucho, al ponerle la colchoneta suda mucho menos y va mas tranquilo así k cumple su función. No le pongo todas las estrellas porque no se puede atar bien a mi sillita y cada pocos días tengo k colocarla bien porque se va moviendo.	positive
No es para nada lo que pensé, apenas si tira vapor, no quita las arrugas, no la recomiendo	negative
Todo correcto. Gracias	positive
No están nada mal. Calidad precio bastante buena, si tiene alguna pega a mi gusto le falta un poco mas de curva que agarre mas la mano del coach	positive
me parece muy pobre solo da un par de recetas	negative
Es muy cómodo pero me esta fallando una cremallera y no se como lo voy a solucionar.	negative
Se usa para mejorar equilibrio y posturas en patinaje.	positive
El producto llegó a tiempo; pero, las cuatro pastillas estaban rotas dentro de su envoltorio plástico. La caja de cartón estaba en perfectas condiciones.	negative
Excelente calidad y acabados. Trae dos correas para amarrar al coche por debajo y evitar que vuele. Recomendable al 100 %	positive
Las compré pero no estoy muy contenta, uno de los mango d la tapadera, se rompió sólo ponerla, los mangos d las sartenes son muy cortos, de momento no se pegan ,jjjjj, a ver lo q dura.	negative
Sabe a cereza, aguanta e hidrata los labios y da un toque rosado a los mismos. Un punto malo es que se gasta en seguida, aunque depende del uso que se le de	positive
Me mandaron una mariquita q no funcionaba, reclamé y en dos días me enviaron otra, perfecto, con la mala suerte que tampoco funcionaba, quise la devolución del dinero y esto ya cuesta más, no solo hace ya más de tres semanas que la espero, sino que encima me pone que me lo añaden a un cheque regalo, o sea q he de volver a gastar quiera o no quiera.... Y así funciona el mundo	negative
Esta bien como complemento del ejercicio diario o para los dias que no haces deporte por diversos motivos, haciendo ejercicio sin esfuerzo en el sofá, pero tampoco hace maravillas. Se puede colocar en varias partes del cuerpo, aunque no queda bien ajustado, tiene 9 niveles de intensidad potentes a partir del tercero y 6 modos diferentes de estimulacion muscular. La bateria dura para 2-3 usos bada mas.	negative
Una pasada de reloj, la batería, su precisión, su construcción robusta y su calidad de materiales, lo hacen perfecto para cualquier deporte, tanto de interior como de exterior. Muy contento con Suunto.	positive
No encajan las tapas. No sirven para nada	negative
Tal y como se especifica en la descripción y se aprecia en las fotografías. Es muy ligero, pesa poquito. Buena relación calidad/precio.	positive
Es útil al tener la semana vista, manejable al no ser demasiado grande, buen tacto y resistente, buena compra en resumen	positive
Me gusta todo en general ,solo que al final termina estropeandose el plateado. Por lo demás todo perfecto	positive
Fabricación española, sencilla de usar , rápida, la jarra termo mantiene el café calentito y no es frágil como la de cristal ( lástima que tampoco se ve el nivel). me gusta más que las de cápsula y llegó al día siguiente de pedirla.	positive
Cumple su función. Buena para masajes.	positive
Es malísimo, las hojas no encajan en el mango	negative
No hemos jugado aún pero son muy chulas y con buena presentación	positive
No cumple con lo previsto. Las sillas que tengo para el coche son muy orejones, por lo tanto la bandana no llega bien a la cabeza de los niños y no les aguanta nada la cabecita.	negative
Todo perfecto menos lo de ajustar el casco, que venía mal y no se puede ajustar bien en la cabeza.	positive
Desde el primer dia de uso el plastico exterior (que hace que el tacto sea agradable) se esta despegando lo que hace que acabe con las manos llenas de trocitos azules (color de la carcasa) a parte de parecer una funda con mucho mas tiempo del que tiene (2 semanas)	negative
Fatal. Ya se me ha roto. Guardé el teléfono en el bolso y al sacarlo ya tenía 3 grietas el cristal templado. Y eso que el teléfono estaba con una funda con tapa también. Me obligan a poner una estrella. No pondría ni 1	negative
Si buscas un protector que pegue por los bordes, este no es el buscas. Transparencia correcta, tacto correcto, pero cuando pase un poquito de tiempo, habrá que quitarlo porque se llenarán los bordes de suciedad. Preferiría que cubriese menos ya que la pantalla tiene una pequeño marco oscuro que es donde empieza la curvatura de la pantalla y quedaría protegido por la funda. Un cristal templado que no pega completamente está condenado a ser sustituido en muy poco tiempo (además que no queda bien estéticamente) Defraudado!	negative
Tiene mala sensibilidad y se despega no facilidad	negative
Ha funcionado bastante bien mientra duro. Los materiales empleados en la fabricacion son bastante buenos pero no con la calidad que esperaba.	positive
Mis hijos están encantados con el juguete. Se pasan horas dibujando con los pinchitos! Hay que tener cuidado qué algunos son muy pequeños.	positive
La crema para una piel grasa es perfecta se absorbe más rápidamente y protege para uso diario, ya es la segunda vez que la compro y estoy muy contenta	positive
Es malísimo. Las sub esferas son una castaña. Son de pego y no sirven ni de adorno	negative
No solo me lleve la sorpresa al abrir la caja en la que venia el producto y vi la taza rota sino que los acabados de pintura también dejaban mucho que desear. . Por lo que me vi obligado a devolverla sin ningún problema.	negative
buena sensibilidad al toque de botones en teclado. Socket de carga y toma de auriculares accesible sin problemas, el único pero es que el botón de apagado lateral de mi Samsung s7 queda un poco duro(escondido de más). En cuanto al amarilleado del plástico, ya veremos cuando será.... ACTUALIZACIÓN : ya está amarilleando, rallado y perdido mucho la sensibilidad táctil de la pantalla. El ajuste de la funda al móvil ha perdido, y aveces se sale por algún lado, cuando lo metes en bolsillos o incluso bolsos....	negative
Todo bien si no fuera porque la bombilla, en todo el espectro en el que es regulable, emite un zumbido muy evidente.	negative
Para mí no es ni la mitad de bueno que el de tapón azul ... Flojito como un colutorio cualquiera del monton. Creo que es poco efectivo	negative
El muñeco está muy bien ,lo que no me ha gustado es que no sabes si te llegará niña o niño hasta que no lo abres!! Yo quería niño, y me llegó la niña , pero a mi hija no le importó!	positive
Muy divertido y de gran calidad, sin duda una gran compra a buen precio. Más divertido que el original al ser de colores y tener el dado	positive
Funcionan bien pero no tengo muy claro si aportan alguna diferencia a la versión estándar, al menos para un uso normal como fotógrafo (para video quizás...).	positive
No solo por el acabado, sino por los recambios incluidos. Es muy práctica, aunque un poco voluminoso el tapón y asa.	positive
No cumple en nada sus especificaciones técnicas	negative
El producto ha llegado en tiempo y condiciones adecuadas. Solo queda darle el uso necesario en mi viaje. La mochila responde a todas las características descritas.	positive
Gran producto, una vez que escurren aísla los platos completamente de cualquier humedad... Los recomiendo...	positive
Es muy débil se han roto enseguida no aguanta el peso de los 5 pantalones	negative
Es un juguete en mi opinión	negative
Es exactamente como venía descrito. El montaje es relativamente sencillo y trae herramientas para atornillar, aunque es más fácil con la ayuda de ua segunda persona para las piezas grandes.	positive
El aparato en sí va bien, pero el touchpad es insufrible y en cuanto al teclado no coinciden las teclas con lo que marcan. Así que tuve que devolverlo. Un pena, porque si cuidaran un poco más los detalles, sería un buen portátil.	negative
No puedo entrar a valorar el producto, ya que no me lo he quedado al llegar una de las copas rotas.	negative
Es una pegatina con poca adherencia, por lo que hay que vigilar que no se despegue, pero desde el primer día se estaba despegando por las esquinas	negative
No se parece a las imágenes que se anuncian, con una calidad inferior a lo que se publica. Vendedor que tendré en cuenta en mi próxima compra para no seleccionar.	negative
Para mi mejor maquina	positive
Lo más ruidoso que puedas imaginar. Es insufrible.	negative
Me encanta su funcionalidad y calidad	positive
Es un parasol dedicado que ajusta perfecto en la montura y te permite poner bien la tapa. Cumple su objetivo muy bien. Como punto negativo, que no es tal, si no lo quitas, en fotos a corta distancia hace sombras. (Me explico: Por defecto lo dejo puesto, que no me estorba. Pero si hago fotos de documentos o con flash a corta distancia/macro, ensombrece una parte de la imagen)	positive
No he recibido nada!	negative
No recomiendo este producto porque no cumple con el anuncio que describe amazon	negative
amos, que si kieres unos auriculares que no tiemes que cargar, baratos i que se suenan bien, ESTOS. i amos, que tienen pinta de durar tiempo. EXCELENTE VENDEDOR.	positive
Enchufar y listo, hace su trabajo correctamente, el ruido es ligeramente más alto de lo que esperaba pero tampoco es un problema. La carcasa esta hecha 100% de plástico y parece resistente.	positive
No es mejor que el hierro de carnicero	negative
Amazon parece tener unos procesos de reacondicionado de los productos que es de todo menos correcto. Deben empaquetar de nuevo el producto tal como lo haya dejado en cliente anterior. Nos ha pasado en repetidas ocasiones. No se han molestado ni en reiniciar el sistema operativo, lo peor es que el portátil presentaba problemas más graves a reparar.	negative
La crema es perfecta en cuanto calidad precio. Es una especie de mascarilla que no necesita aclarado con lo cual la dejas toda la noche. Tiene una textura suave y agradable. Te deja la piel fresca y con sensación de descanso. Lo único malo es que no viene bien embalada, de hecho no trae el precinto de seguridad o plástico que lo recubra, eso crea desconfianza a pesar de no parecer usada. Por favor subsanen ese inconveniente pues influye mucho a la hora de volver a comprarla.	positive
Es bonito, es práctico pero se sale el agua cuando se derrite el hielo. No la volvería a comprar.	negative
Producto tal y como esperaba. Muy práctico y cómodo de usar.	positive
Funcionan a la perfección, se sincronizan de manera inmediata, dando buena calidad de audio y micrófono. Su estuche powerbank además de recargarlos, es pequeño pero resistente.	positive
La máquina es perfecta, muy fácil de usar y muy manejable, la he probado durante un buen rato cogiendo bajos de pantalones y va muy bien.	positive
Queda levantado por todo el lateral, no queda nada bien colocado y a parte da la sensacion que en 2-3 días se empezará a despegar y a poner suciedad.	negative
Y me llega el paquete con 4 coches y abierto???? Pero menuda broma es esta!! No es que no sea serio, es que me parece muy fuerte. Alucinando estoy, y con cabreo!	negative
Muy recomendable, se adapta perfectamente a todas aquellas bicicletas sin ojales para las que es difícil encontrar un portabultos.	positive
Se ha usado mucho y va muy bien, todavía dura	positive
La cachimba vino genial. Encantado con el producto ya la he probado y 10/10.	positive
El agua hace daño al salir y pierde temperatura por la dificultad en la salida. Si que se nota menos sequedad en la piel.	negative
Es muy mona pero me llegó rota una esquina.	negative
Muy buen producto. Aguantan muy bien los lavados, y es muy agradable su uso.	positive
Buena calidad pero pequeño.	positive
No cubre toda la pantalla, los bordes se quedan sobre parte visible de la misma y estorba en el visionado. Para ponerla... o yo soy muy torpe, que puede, o tampoco es tan fácil, la herramienta no sujeta bien. Quitada y tirada	negative
el sensor es muy sensible y tengo la rejilla del coche en vertical y la pinza que sujeta el cargador a la rejilla está sin fuerza no puede con el peso del teléfono 180 gramos no lo sujeta, no estoy satisfecho con la compra	negative
Es la primera vez que compro sillas online sin verlas antes un situ. Y me ha sorprendido gratamente . Fáciles de montar, la que me han llegado a mi en concreto no cojean . El modelo es básico pero bonito. Dudaba entre el rosa palo o El azúl verdoso, al final me decanté por este último y la verdad que no me Arrepiento. Parecen bajas, pero es una sensación óptica, medí la altura del asiento al suelo y es exactamente la Misma medida a las que tenía yo anteriormente . En definitiva, me gustan.	positive
Camiseta bonita pero más grande de lo esperado. Pone camiseta 7-8 años. Mi hijo tiene 7 años y es alto y le quedaba muy grande y ancha. Salvo el tamaño es muy bonita y la calidad del tejido buena.	positive
Muy bueno y ha llegado bien	positive
Muy rápido el envío E s exactamente lo que buscaba!! Volvería a Pedir sin duda. Muy contentas con el trato	positive
El estuche muy bien. El transporte de pena. Con amazon prime y no llegaba nunca. Y postventa inexistente. A mi queja me respondieron que era cosa de Amazon.	negative
Srs: Aún estoy esperando la factura. No lo recomiendo a nadie. Duró una semana. Y no tuve nunca la garantía.	negative
NO VALEN PARA E90 del 2008 con xenon! Despues de desmontar rueda, guardabarros y demas ( 45 min ) resulta que no es la bombilla correcta!!!!	negative
Cuidado! No llega nunca y no te devuelven el dinero. Me dijeron que posiblemente se había perdido en la aduana, que me devolvian el dinero, pero eso no es cierto.	negative
El papel entra demasiado justo. Creo que es pequeño	negative
Imposible que lea el codigo QR del movil. La camara viene en su codigo con US de USA. Puse enl a app USA y tambien probe con spain. Pero nada ...no me lo lee...Alguien sabe de que puede ser?	negative
Lo he usado poco y ya me cuesta mucho encenderlo, no me hace chispa. Y como se ha dicho, el fuego mínimo es muy fuerte. No quema bien.	negative
Para lo que cuesta no esta mal, trae cuatro tornillos para colocar debajo de la plancha y así poder nivelarla, el problema es que uno de ellos no entra en el agujero ya que está mal hecho, las instrucciones vienen en chino y tienes tu que indagar el funcionamiento, la parte donde esta el contador de tiempo y temperatura he tenido que desmontarlo ya que venia suelto con los tornillo flojos, es decir un desastre.	negative
Muy buena adquisicion, hace su función con creces	positive
Tiene buena pinta pero el tallaje es pequeñisimo	negative
Como esperaba, estupendas.	positive
La funda es súper Fina , no abulta nada, muy cómoda. Por ponerle un pero es algo resbaladiza, pero buena compra y recomendada.	positive
En mi opinión no volveré a comprar esto se queda todo dentro de la cápsula y lo poco que sale sabe a agua.No lo recomiendo	negative
Muy bien empaquetado y conforme a lo que especifican en el artículo. Perfecto para manualidades.	positive
Ha venido sin el conector rápido.	negative
Me ha encantado esta cuchilla, se me rompió la que venía con la maquina y este reemplazo me ha ayudado mucho. Es igual, por no decir idéntica, a la de que venía de serie con la máquina. 100% recomendable.	positive
Buena calidad y buen precio	positive
La funda está bien pero no encaje a perfección se queda algunos botones como el del sonido y el de apagado tapados	negative
Aguanta el tirón relativamente bien; tu móvil no saldrá volando al primer bache. Sin embargo, sí que aparecerá mirando hacia donde el azar determine, lo cual no deja de ser disfuncional.	negative
Gracioso, ligero, útil y en precio. Muy fácil de montar	positive
Me duró exactamente una semana. Se despegó la ventosa a la semana, se cayó contra el salpicadero y se rompió	negative
No los recomiendo ni los vuelvo a comprar, no me han llegado a durar 3 meses y practicamente sin usarlos. Debe fallar el cable en su union a la clavija	negative
Llevamos muchos años utilizando esta marcha de etiquetadora y es la más duradera para el uso que hacemos.	positive
Me ha llegado con varios daños. Es una pena porque la rueda es muy guay y suave. No voy a devolverlo porque no quiero perder mi tiempo en los correos, pero espero que estos daños no se hacen más graves y la rueda pierde su funcionalidad.	negative
No es ninguna maravilla, pero por lo que cuesta se puede tener para algún uso esporádico, sin más	negative
El producto todavia no me ha llegado, poca profesionalidad.	negative
El producto es lo que esperábamos,el problema fue con el envío,al comprarlo ponía que lo recibiríamos en dos días,en este caso un viernes y lo recibimos el lunes por la tarde	negative
Justo lo que buscaba,se ajusta a lo que dice el vendedor,lo recomiendo	positive
Inflador de aire, va bien para colchones y colchonetas, el tipico INTEX que hay en cada casa de estudiantes. Sin embargo no es un compresor, osea que no lo compres si esperas inflar globos, apra eso necesitas inyectar aire a mucha presión ( aunque no lo parezca) y necesitaras un compresor de aire, no una bomba. Teniendo esto en cuenta del resto va bien, compacto y portatil, simple pero por el precio te ahorra un trabajillo cuando vienen los invitados, no se le puede pedir mucho mas.	positive
La compramos para un niño, decir que la bateria dura apenas 2 horas si llega. Despues al intentar meterla en una funda de protección para niños, al apretar un poco la pantalla se rompio por dentro. Muy muy frágil	negative
Perfecto. Cumple mis espectativas. Espero que resista bien el uso sobretodo porque estará húmedo con frecuencia. Llego a tiempo y muy bien protegido dentro de una bolsa de tela. Lo recomiendo	positive
Aún no he recibido el producto, pese a que estaba previsto que llegara el 19 de febrero. Confío en que llegue antes de Carnaval, ya que lo he comprado precisamente para esa fiesta, con la suficiente antelación.	negative
La utilizo para ir a trabajar y cumple su funcion. Muy comoda y esteticamente bonita	positive
Es lo que buscaba, pero para viajes es un poco grande.	positive
Material de poca calidad	negative
No es el producto pedido, el pedido era cordón de cuero de 2mm y lo recibido es de 1.5 mm.....	negative
El cristal de la cámara no dura nada	positive
Tiene una buena precisión en tensión en todo el rango y el limitador de corriente funciona bien. Un buen producto para el precio que tiene.	positive
Acabo de comprarlo y no puedo acceder al su lectura.	negative
No es un buen protector para que la pantalla no se rompa. Es un film que se puede doblar y cortar, como el film protector con el que vienen de fábrica las tablets o teléfonos.	negative
Indispensable para cualquier labor de tapicería. Sin este destornillador quita grapas y tachuelas me hubiese representado una gran dificultad el reemplazar la tapicería de cuatro sillas.	positive
Me han funcionado perfectamente. Lo he utilizado para un Honda Accord y lo hice sin ningun problema. Quizas me hubiera gustado que las garras fueran un poco mas grandes pero aun así cumplió con su cometido. Muy contento con el producto respecto a calidad - precio.	positive
Las luces funcionan mejor de lo que me esperaba. Tienen dos problemas, el primero que no encaja igual de bien que las de fábrica en mi audi a3 del 2011, y el segundo que los tornillos de las luces originales no sirven para estas.	positive
Llegó 2 días después pero bien encaja para mí campana cata perfecro	positive
Desastre. Tenía entendido que Taurus dejaba que desear y lo he comprado. Devuelta el mismo día: no hace contacto y si fuerzas suena chispazo.	negative
Estoy encanta muy bonita y el material está muy bien me llego justo el día k me dijieron	positive
Cumple de sobra con mis necesidades de cada día.	positive
El envase no se corresponde con la descripción del producto. Entregado con bote plástico+spray	negative
Nefasto, roto a la primera y gracias, ya que de lo contrario y en uso de accidente hubiera tenido un disgusto.	negative
Buen aparato, reproduce (calidad media) como walkman, pero para pasar tus cintas a PC... No sé cómo será, pero a Mac... Difícil, difícil... descargué software, lo intenté, pero no era nada sencillo, no viene nada de ayuda en ese sentido, no es como introducir un CD y extraer las pistas... Chin Pum.	negative
Tiene una apariencia muy similar a la madera. Es de goma flexible y resistente. Añade un plastco para la pantalla. Como punto negativo es algo resbaladiza.	positive
Tal y cómo llegó a casa la devolví. Le pongo 3 estrellas por las facilidades para devolver el producto, pero el producto en sí no me gustó nada. No se conecta a wifi, va con un mando y no lo puedes controlar con una app ni con un asistente tipo Alexa. Sin manual de instalación ni ningún tipo de indicaciones para saber qué es cada terminal.	negative
Mientras que la cafetera parecía nueva, el filtro de dentro (el que tiene la junta de silicona) se veía usado y además estaba golpeado, entiendo que lo habrían sacado y golpeado de alguna forma. Me siento estafado.	negative
Complementa la utilidad de los focos recargables, para espacios sin conexión eléctrica.	positive
Fatal, la batería no dura más de 20 minutos, se apaga cuándo está en porcentajes como 80% o 70%, lo pongo a cargar cuándo se apaga y me pone que está otra vez a esos porcentajes. Es una lotería, me es imposible usarlo sin estar cargando ya que no se cuánto va a durar la batería.	negative
Demasiado pesada. Forma oval	negative
Se da mucho se sí, dejando toda la marca de la muñequera	negative
Malísima valoracio , todavía no lo he recibido desde hace 20 días que tenía que haber llegado , y no me solucionan nada . Nada recomendable	negative
Excelente producto por la sensación de suavidad que deja en la piel y excelente olor. Fácil y cómodo de aplicar, compraré de nuevo el producto. Yo lo aplico en glúteo y piernas. No puedo decir que en tan poco tiempo , un mes, haya visto resultados extraordinarios pero soy una persona paciente con los tratamientos así que seguiré con ello . Producto barato y fácil de uso; y tampoco he visto ninguna contraindicación o efecto negativo en mi piel . Un saludo!	positive
Decepcionante en cuanto a las facilidades de montaje. Es Extremadamente fino. Para que quede un poco rígido hay que ponerle ganchitos en todas las posiciones y solo te mandan unos poquitos con los que no tienes ni para empezar.	negative
ASICS siempre una talla más a la que tienes habitualmente. Debería ponerlo en la foto.	negative
Lo hemos comprado hace un mes no aspira bien la bateria no aguanta nada menos de 30 min y tiene que estar cargando 24 horas	negative
Se atasco con la primera hoja. Tuvimos que devolverlo.	negative
una replica de m****a!no dura nada!por lo menos que ponga con 5€ no con 32€ como el original!voy a dejar de comprar colonias en amazon...	negative
Funcionamiento perfecto, se escuchan muy bien.	positive
No sé si lo hago mal. Me gusta como queda en apariencia pero la verdad es que el pelo me resulta difícil de peinar después de usarlo. Lo quedo liso tras peinarme sufriendo de tirones. Mi valoración es positiva porque es lo que ofrece. Cera de color blanca para el pelo.	positive
El papel es muy fino y el rollo es muy pequeño	negative
Una de las baterias no carga	negative
El móvil hay que situarlo de una manera muy concreta para qu cargue. Tengo otra base más pequeña y va mejor. No lo recomiendo.	negative
La llevo súper cómoda. No pesa nada, no sé desabrocha por el tipo de cierre que tiene y es muy bonita.	positive
A LA FECHA DE HOY 07 DE AGOSTO DEL 2018 NO HE RECIBIDO ESTE ARTICULO	negative
De buena calidad y parece resistente. Lo único, necesita mas capacidad para el agua. Se les termina muy pronto ya que cada chorro consume bastante y hay que estar llenando a menudo. Para abrir la tapa, hay que girarla un poco y levantar.	positive
Esta muy bien para el precio.	positive
Muy bonitas y de calidad perfecta	positive
Después de días esperando me llega el producto en una caja de cartón rota y el láser echo un asco.. Solicito la devolución.. Y aquí viene la odisea porque es un vendedor externo.. Después de tantos mensajes acordamos que me envía otro.. Un mes después aún lo estoy esperando.. No sé como permite esto amazon.. Muy descontento	negative
Me esperaba que tuviera más calidad es difícil de poner y queda pompas de aire por mucho que apriete	negative
No me han llegado a durar dos meses cada par andando descalzo sobre suelo de parquet. No repetiría.	negative
El molinillo viene con una pestaña de la tapa inferior de cierre rota, por lo que todas las piezas están desmontadas. No encuentro la forma de montarlo. Necesito que me indiquen como deben colocarse las agujas para que coincidan bien las ruedas dentadas. Si no, devuelvo el producto.	negative
La compre para un viaje en concreto y por ese precio la verdad que no se puede pedir mas por menos	positive
En Noviembre compré el reloj para poder usarlo en las clases de natación, ya que se supone que es un reloj apto para ello, pero ya no funciona correctamente. Cargamos el reloj y aunque indica carga Full, no es correcto, ya que a los pocos minutos de ponerlo en la muñeca se apaga. Además, que cada vez que se apaga,al encenderlo tienes que volver a configurarlo desde cero. Estamos muy descontentos con el producto, hacemos bastantes compras en Amazon, y es la primera vez que nos ocurre salvo así.	negative
El servicio de Reparto de seur es muy pésimo. Lo ha dejado en un punto de Recogida alegando de que no estaba en casa.todo es mentira si estaba en casa.	negative
Me ha solucionado los problemas	positive
La calidad del producto es muy buena, sin problemas para instalarlo, teclas con suavidad y el ratón preciso y silencioso.	positive
Producto de calidad sencilla al tanto y a imagen	negative
La primera vez que fallas el tiro, la peonza se raya completamente. Una vez que la bailes al revés, lo cual es muy habitual, se descascarilla todo el plástico superior. La compré de metal porque el plástico me parecía endeble, pero gastarse 25€ en un trompo que media hora después de dejárselo a un niño, parece que está para tirar... Me arrepiento de no haber comprado uno de madera de 2 euros.	negative
... Y no me importaría pagar mas. Para empezar, el transformador de poca calidad junto con el cable, el aparato igual, plásticos baratos con botoneras muy deficientes y pequeños para ser un dispositivo que tienes en la mesita de noche de la cama, cuanto tienes la radio puesta o el sistema inalámbrico para conectar el móvil ¡NO SE VE LA HORA!... El sonido muy deficiente; un aparato con sistema de carga QI se merece más calidad acorde con los usuarios de este tipo de dispositivos de gama media/alta.	negative
semillas diminutas, no se si es semilla o la piel de las mismas, está tan molido que no se aprecia nada.	negative
Horrible y peor servicio tuve que ir a correos a por el, ya que no lo acepte, lo rechazo y aun así me lo cobraron, ahora estoy con un producto que rechaze al minuto de pedirlo y que me gusta, devolverlo me cuesta dinero... En fin	negative
Producto muy bueno, corta bien, no da tirones y viene con accesorios muy útiles, en proporción a lo que cuesta muy buen producto	positive
El artículo son 5 libretas con gusanillo. Pero sólo ha llegado una. Lo he devuelto. Estoy un poco molesto. Lo compras aquí para no tener que ir a la tienda y al final pierdes más tiempo. Tengo que imprimir la etiqueta y quedar con el mensajero o peor aún ir a la oficina de transporte. Si son 5 libretas no se por qué envían una!	negative
No creo q sirva para mucho.	negative
Son enormes, si tienes cara fina, como yo, te comento toda la cara. A mí no me gustaron y las devolví. No sientan como esperaba	negative
perfecto en sensibilidad y en comodidad y como no en entrega.	positive
Mi madre me lo pidió para depilarse los pleitos sueltos que le salen por la cara.. es muy fácil de usar.. llevar una pila.. con lo cual lo puedes llevar en el bolso.. llegó muy rápido.. bien embalado y presentado.	positive
Queria la alfombra para pones sobre el cesped artificial, el viento la levanta pq s muy ligera, hay k sujetarla con piedras y la petra al pasar por encima con sus garras me la agujerea, poco me va a durar.	negative
Buena calidad de la navaja, viene con cuchillas dobles y simples. Es cómoda y buen diseño en relación al precio. El peine-molde es de plástico y cumple su función. Buena compra calidad - precio	positive
Lo esperado. Comprado por comodidad, pero sale caro con los gastos de envío.	negative
No funciona la batería en la psp de ninguna manera, y es la suya, nada que hacer, se carga pero no va	negative
Igual que el que jugamos. No lo encontré en ningún sitio... Solo aquí. Muchas gracias. Es muy entretenido para los niños y mayores.	positive
un poco cara de precio pero cumple su funcion	positive
La tinta de las flores destiñe	negative
Fácil instalación y posibilidad de montar dos cámaras, aunque en mi caso solo utilizo una. No es posible visualizar las dos cámaras a la vez en la pantalla, aunque se conmuta la imagen cada vez que se activa la marcha-atrás.	positive
Se mueve mucho cuando lo pones en la boca	negative
Para empezar, el vendedor no me dió ningún tipo de número de localización para saber por donde iba el paquete, tuve que pedirlo yo. El funko llegó en una bolsa de plástico sin ningún tipo de protección y cuando la abro, la caja viene totalmente rota y arrugada, por suerte el funko estaba bien pero el embalaje fue horrible, se puede ver en las fotos. Le doy una estrella y porque no le puedo dar menos	negative
Bien. Es como se describe.	positive
todo según marca el producto	positive
Mi mujer esta encantada, dice que despues del verano con los pies como se le habian quedado con durezas y secos , este exfoliante le ha parecido muy bueno, es suave pero te quita las celulas muertas en cuestion de nada. A parte que la verdad, huele de un bien... tiene que tener algun elemento refrescante porque deja los pies como fresquitos, ademas hemos usado muy poco, cunde mucho. Estamos contentos con la compra y compraremos mas cuando se acabe.	positive
Facil de instalar y muy resistentes. Soportan bien el peso y no se despegan a pesar de ser pequeños.. Los recomiendo.	positive
llego mas tarde de lo qeu tenia que llegar y encima eran anillas de llavero de las normales redondas i de lo mas feas que hay nada qeu ver con las de la imagen planitas que dan una sensacion de calidad con acabado cromado	negative
la verdad es que no esta mal ideado , pero a mi no me gusta , se ve mucho en el reloj y para mi lo encuentro feo,	negative
La sensibilidad de la pantalla con este protector es muy mala.	negative
Es perfecto para guardar un móvil y evitarle golpes.	positive
De momento bien, veremos en un tiempo si cumple	positive
Llego rápido y funciona fenomenal la pulsera, la recomiendo	positive
Nefasto! Usan la peor agencia de transportes del mundo! El producto les va a llegar roto si o si. Busquen cualquier otro proveedor que seguro les dará mucho mejor resultado tanto en calidad, servicio y sobre todo atencion post venta	negative
Es tal cual se muestra en la foto. Y son bastante grandecitos como para meter cosas dentro. Son de tacto suave y bonitos. Muy útil que traiga colgadores para poder colgarlos sin ningún tipo de dificultad. Estoy deseando que llegue la navidad para ponerlos!	positive
me a gustado mucho es muy bueno estoy muy contenta	positive
Funciona pero necesitas el cargador (que no es de iPhone)...un poco lío ya que creía que funcionaba directamente conectado al iPhone...aun no lo he podido utilizar para lo que quería	negative
Muy bonito tapiz, lo recomiendo para espacios alegres y llenos de luz.	positive
Lo usé para la fiesta de cumpleaños de un niño les encantó	positive
No era el producto que pedíamos y no he podido devolverlo porque la tienda no contesta a los mensajes	negative
De momento funciona bien, es lo que esperaba. Ya he tenido varios y duran lo que duran. pero estoy contenta con la compra. un saludo	positive
Se oye antes y mas fuerte a Alexa, dando aviso de llamada. Solo lo compraría para una casa muy grande.	negative
Se adapta perfectamente al producto. Pero el precio es algo elevado	positive
bonito diseño, buen material, después de tiempo de uso esta como el primer día	positive
Aun no he jugado a Estel juego, pero al abrirlo las ilustraciones de las cartas no son ni parecidas a los personajes de verdad	negative
La caja es con brillo, y si la miras al trasluz está con rayas.	negative
de lejos se nota de verdad se brilla	positive
es tal cual la foto y facil de montar	positive
Lo voy a devolver directamente. Porque no esta presentable para regalarlo en estas condiciones.	negative
Muy bueno para piel atópica.	positive
Si bien la batería llegó en perfecto estado y funcionando correctamente esperé durante casi 10 días para recibirla, desde una ciudad que está a 2 horas en coche.	negative
Yo compre todo el equipo taladro de TACKLIFE por su poco peso ,se adapta a las personas mayores, y una batería mas ,calidad en comparación de precio es un regalo ,esta herramienta estuvo en rebaja en amazon mucho tiempo	positive
No tienen un buen pegamento, solo un poco de calor y se despega ,y mala textura, además de muy estrechos, mejor de 19mm. Arrepentido de la compra.	negative
Aun no me ha llegado el paquete, tarda mucho y ya ha superado en 6 dias el tiempo estimado de entrega.	negative
Lo compré para regalo, lo cual lo tuve un par de semanas envuelto...para sorpresa de que venía con error de fábrica, el cinturon estaba al revés y es imposible girarlo porque viene pegado al traje...	negative
Es mas seguro que el original	positive
Ligerito, fácil de llevar si sales de viaje y es bastante potente, varias velocidades aunque la temperatura es algo alta.	positive
Pequeño, no me entra el móvil	negative
Me han enviado un artículo de segunda mano con grasa y migas en la base del producto l, en vez de uno nuevo. Venia en caja abierta sin envoltorio de Amazon.	negative
no vale para nada la usado una vez para purgar los frenos de mi coche ni siquiera e podido terminar es un juguete	negative
Muy buena opción para suprimir bidé, que he utilizado desde niño y éste grifo lo suple sobradamente. La instalación por mi, que soy un manazas, ha quedado perfecta. Lo único que he tenido comprar en fontanería un pequeño latiguillo para la cisterna que me ha costado 1€. Mi mujer también opina lo mismo.	positive
El contador no funciona... hace ruido pero no cuenta las vueltas. El paquete llegó bien, en tiempo. Pero el reloj no funciona.	negative
Estoy a la espera que aún venga la empresa de mensajería para iniciar la devolución	negative
Uno de los mejores inventos de la historia XD	positive
Depende demasiado de la intensidad de sol	negative
Probado durante tres meses. Buena estética y acabado de trabajos. Fácil de usar. Los trabajos a realizar serán algo lentos ya que rellenar todos los huecos que trae es lento, pero el resultado final es estéticamente muy bonito y poco visto. Yo opté por dar pigmento y rellenar juntas con arena y cemento en seco. Única pega: dificultad para lavar después de cada jornada ya que son muchos huecos y muy pequeños	positive
Geniales calidad/precio Lamentablemente se le ha ido todo el tinte azul y ya es imposible de ver bien, han durado muy poco y la buena impresión inicial se ha vuelto malísima. A comprar otras.	negative
Me ha gustado mucho el diseno. Sencillo y elegante. Cumple su función perfectamente por un precio muy bueno. Por ahora no tengo quejas de su funcionamiento. Muy facil de limpiar	positive
El producto me ha llegado con la caja rota. Saludos	negative
Los vendeis con defectos	negative
Los bordes no se quedan pegados y deja parte de la pantalla sin cubrir, cosa de la que no te das cuenta hasta que lo instalas y entonces ya no se puede devolver..muy mal, no lo recomiendo	negative
No tiene 24000 nunca! No carga 2 veces un móvil. Fatal, no lo compréis!!!	negative
Buen producto y excelente trato del vendedor. Recomendable al 100%. Le solicite al vendedor las instrucciones en castellano y sin demora me las envío al correo electrónico.	positive
Calidad precio muy bien y capacidad tambien lo que app no funciona	positive
Tal y como se describe. Llegó mucho antes de lo esperado, así que encantados con la compra.	positive
Estoy muy contento con la compra. Llegaron bien embalados y a tiempo. De buena calidad. Recomiendo compra por calidad precio.	positive
Todo perfecto, tal y como indica	positive
La descripción dice que es compatible con el Samsung Galaxy J5 pero le va pequeño, la pantalla es más grande que el cristal. No es compatible. He solicitado la devolución	negative
Les he tenido que quitar la plantillas porque se movían y eran incómodas	negative
Desde q la compré no he tenido ningún problema. Es sencilla y fácil de usar. Me gusta sobre todo porque el aparato para meter la cápsula va a parte.	positive
Funciona pero no con todos los cables	positive
Es muy práctico. No es el color que pedí.	negative
Se despega al momento, lo compre para camuflar un objetivo fotográfico. Al final es barato el producto pero sale caro porque no pega.!!	negative
Contra: Es bastante pequeño, no cabe medio litro de agua. No se puede elegir el color de la luz LED; ésta va cambiando cada pocos segundos. Caro para lo que es. Pro: Sale bastante vapor.	negative
El libro en sí es original y esta divertido, pero su funcionamiento... las solapas que han de salir estan duras y al ser carton hay que gastar cuidado, algunas páginas venian pegadas entre sí y el libro algo deteriorado. Este es el segundo, pues el primero estaba peor y encima una de las solapas estaba rota, por que solicité un cambio y amazon como siempre increibles en el trato al cliente	negative
Comodo, buena visibilidad y sumergible. la brujula funciona bien. El termometro hay que usarlo con el reloj quitado y asi y todo no es muy fiable, aunque hay una opción para ajustar la temperatura a la de un termometro fiable.	positive
La funda encaje muy bien y protege el reloj, solo espero que no cambie de color como la anterior que tenía, que paso de transparente a amarillenta a los pocos meses de tenerla.	positive
No es el cepillo de mayor potencia que he tenido pero por relación calidad precio va fenomenal.	positive
Perfecto. Tal como se describe. Ideal para encenderlo en zonas con viento. Ligero. Se recarga con el cable del movil, un miniusb normal .	positive
La piscina es preciosa y nos llegó antes de lo previsto. El único problema es que está rajada.. :-(	positive
No ha durado ni un año. Aunque mientras duró molaba mucho.	negative
No está mal, quizás un poco tiesa, pero me vale para lo que la compré. Perfecta para un mástil.	positive
le doy 2 estrellas por que para mi octavia del 2005, los tapones para los tornillos normales van bien, pero el de la tuerca de seguridad es mas grande (y eso que es la original). una pena!!!	negative
Buena calidad. Muchos compartimentos interiores y exteriores. Bien acabada. Tela de calidad y detalles. Muy recomendable para llevar tecnología en ella.	positive
Nunca me llego el pedido!Vendedor poco serio.	negative
Fue un regalo para mi padre y está contento,le da un servicio que necesita.la única pega que tarda en calentar.	positive
Protege de golpes pero para monitorizar el rato de natación lo tengo que quitar porque no se accede bien a los botones y tampoco funciona bien la pantalla táctil. Se mete agua entre el reloj y el protector. Para proteger de golpes habría servido el otro más barato. Compré este porque lo ponían muy bien pero mi experiencia no ha sido muy buen	negative
Son muy resistentes , perfecto tamaño para el coche , la carga es rápida	positive
Totalmente decepcionado. Hace ruido, no calienta y venia usado.	negative
Me encantó el producto!! Pensaba que podía ser un poco pequeño o incómodo pero es excelente! El tamaño es genial, caben incluso dos personas adultas de manera cómoda. Es el flotador que más me ha gustado hasta el momento y que más he utilizado. La única pega que podría poner es que no estás nada en contacto con el agua, en mi caso me gustaría que tuviese un área más sumergible.	positive
Todo perfecto. Regalo para mi pequeña que se la pone en bucle	positive
no sirve para nada, no es ni bonito ni gracioso, cuando esta en tus manos es una aberración, ademas de mala calidad el morro se sale y los detalles son pintura y mal acabados, además huele mal.	negative
Bonita lampara de mesa, hace su trabajo aunque la luz no sea muy fuerte pero al mismo tiempo se descarga muy rapido. Habria que dejarla enchufada todo el tiempo.	positive
Fatal. Nunca lo recibí y me hacía mucha falta. Tuve que pedir un reembolso. Una vergüenza. Tengo contratado Prime y no lo recibí al día siguiente, si no pueden ofrecer este servicio que no lo oferten.	negative
Acabo de recibirla y ya voy a llama para hacer la devolución porque me llego usada en ningún lado me decía que era usada y rota y la caja abierta	negative
Son de tacto muy suave,a mi bebé le sirve para después de comer que vomita la leche,absorbe muy bien	positive
Todo bien .producto perfecto se ajusta a lo pedido. Super rápido un día en llegar . Muy contento con la compra .	positive
Es una lástima que haya tenido que devolverlo, pues se reiniciaba cada tres ó cuatro minutos mientras veía una peli. Eso sí, Amazon funciona de miedo...ningún problema con la devolución.	negative
Viene empaquetado en una bolsa, sin caja y sin cable. El cargador de arriba y el de la izquierda es el original, que viene en caja Samsung blanca, precintado, con pegatina 3D de Samsung original y viene con cable. Ambos vendidos por Amazon.es	negative
La ducha es tal y como se ve en la imagen, de calidad buena pero no me avisaron de que venía el pedido como con otros, eso si llego antes de lo previsto	positive
Según ponía en las características, pues a oscuras no se ve nada. Las instrucciones sólo vienen en Inglés y alemán, por lo que no sé como usar la esfera 24 horas para poner el uso horario de otra ciudad.	negative
Estoy muy contenta con esta funda, es muy muy bonita.	positive
Es de lo peor que he comprado nunca por amazon. Eatos auriculares son horriblemente malos. 1. Mal sonido 2. Al hablar por telefono el otro no te oye bien 3. La batería no dura nada 4. Son muy grandes e incomodos En definitiva. Dinero tirado a la basura!!!	negative
No funciona. Es un timo total. Me hace marcas y no cumple con su función, vale mas la pena gastarte un poco mas y comprar algo que si vas a poder utilizar.	negative
la correa del cinturon un poco corta me he tenido que comprar una aparte y la tela muy tiesa pero con un par de usos ya es mas docil y va muy bien	positive
Cero estrellas Es una auténtica porqueria y ya no solo por los materiales que por 3€ que vas a esperar pero al menos que los cactus estén derechos no? Que están tumbados! Madre mía... 🤦🏼‍♀️	negative
Llegó muy sucio impresentable	negative
Cumple con las expectativas...muy a gusto con la compra...tiene mucho espacio y es fácil de transportar. Muy recomendable para regalar.	positive
No lo compréis pues las tallas no tienen nada que ver con la realidad y cuando vas a hacer la devolución a China resulta que vale más el envío que el producto . Muy disconforme.	negative
Cómodas, buen tejido, finas pero cuesta de quitar las manchas. Es tamaño salvaslip.	positive
No ha llegado en las fechas precisas y no dan solución alguna para que me lo entreguen ya o devuelvan inmediatamente su dinero	negative
Mala calidad. No hemos podido ni estrenarla	negative
El ser humano es pura contradicción. Puede amar odiando, reír llorando, sufrir disfrutando. Todo individualmente, todo a la vez. Alejandro nos pone frente al espejo de nuestras inseguridades, pasiones, deseos, anhelos,, de nuestras virtudes, que son al final, nuestros defectos, nuestras contradicciones.	positive
Me encanta lego duplo, y a mis peques tambien. Recomiendo este tipo de juguete totalmente, facil de encajar para los mas pequeños.	positive
Cargó bien durante la primera semana. Desde entonces, funciona cuando le parece, muevas los cables, conectes o desconectes, carga a ratos. Supongo que acabará por fallar de manera definitiva. Mala compra, reclamaré para solicitar garantía.	negative
Increíble muy aconsejable	positive
Despues de 2 meses escasos de uso, acabo de darme cuenta de que el soporte central se ha hundido de forma considerable. Si sigue a este paso en un mes mas, tocara el suelo, y sera totalmente inutilizable. Un desastre. Espero que se pongan en contacto conmigo los vendedores para darme una solucion.	negative
El color chocolate muy oscuro, casi negro es muy elegante y absorbe genial el agua. Se lava perfectamente en la lavadora.	positive
Cómo se ve en la foto	positive
Es pequeño y barato pero bastante cutre el mecanismo para bajar y subir los personajes y no se suben y se bajan bien. Podían haber buscado otra forma como en el que no es de viaje.	negative
Trituradora de papel buena. Tritura muy bien, pero está enfocada para las tareas típicas de una casa. Algunos recibos, alguna que otra carta etc. No se le puede meter mucho de golpe, pues el motor se satura y puede quemarse. Es conveniente engrasar las cuchillas de vez en cuando.	positive
En esta ocasión me he encontrado nudos en la bobina en varios recorridos del filamento, lo que ello implica que pierdes algunas piezas a medio imprimir. Es la primera vez que en esta marca me encuentro con este problema. Tengo otra bobina y espero que no tenga este problema.	negative
Funciona bien y no se aprecia la camara. Puedes cambiar el tipo de resolución del video y carga de verdad el teléfono. La aplicación es fácil de utilizar, me permite ver el vídeo online o ver lo que tengo grabado en la memoria.	positive
Buena compra, de hecho estoy meditando adquirir dos personajes más de Juego de tronos.	positive
Son un desastre llevo un mes para que me digan que pasa con mi teléfono y nada. Se lo envié porque se quedó bloqueado y nada sigo sin teléfono.	negative
Perfecto para meter muchas fotos, cada foto va protegida por su plástico individual.	positive
En una de las imagines indica 19 cm y no es real. También indica muñeca y es una figura. Deberían modificar la descripción ya que la utilidad no es la misma.	negative
Es bastante bueno, elegante y cómodo. No conozco otros, pero este está bastante bien.	positive
Mi hija de 7 años lo tiene siempre cerca cuando va a hacer las tareas. Un imprescidible para estudiantes de inglés.	positive
en la descripción lo venden como si fuese cristal templado y eso es falso es de plástico, pero bueno encaja bien y por lo menos algún arañazo protegerá.	negative
Se despega y no reconoce bien la pantalla táctil, 10€ tirados a la basura.	negative
Es bastante bueno por el precio que tiene las calidades son buenas, más que aceptable. No dudaría en volver a comprarlo.	positive
Cumple con lo anunciado	positive
A pesar de ser de cristal, llegó en perfecto estado	positive
La verdad es que estoy contenta. Es fuerte y queda en su sitio. Eso sí, lo que hace es recoger un poco, no esperes que te va a dejar plana porque eso es imposible.	positive
La mochila es preciosa, justo del tamaño que la buscaba ni muy grande ni muy pequeña.	positive
Son muy chulas y baratas le doy un 10	positive
Funciona tal y como se esperaba. Llego en tiempo indicado.	positive
Es una basura y no funciona	negative
no funciona corectamente, no hace foto, me perdi las piezas de reloj y ahora no esta tan presentable. no recomiendo	negative
Dura muy Dura muy poco la batería pésimo sonido la Dura muy poco la batería pésimo sonido Dura muy poco la batería pésimo sonido sonido	negative
Calidad muy regular para coser a máquina, a mano sí dan el pego. Depende de para qué los necesites valen la pena o no...	negative
Dió tres puntadas , y nunca mas volvió a coser.He visto videos en internet, y está correctamente enhebrada.No la recomiendo	negative
Muy buen tripode para uso prefesional. Buena marca, robusto y la cabeza va muy fluida. Lo utilizo con una blackmagic cinema 4k que pesa unos 4kg + el objetivo que seran unos 0,4 kilos y va perfecto.	positive
Compré 2 para el maletero de mi Cali Ocean y casa con el espacio, quedando un pequeño hueco para las almohadas	positive
Es una estafa, el producto nunca llega y tampoco contestan a los mail! No comprar!	negative
Me ha gustado mucho, deja el pelo muy bien. Lo tengo teñido y dañado, y he probado casi todas las marcas buenas. Repetiré. Es la segunda vez que la pido.	positive
Horribles, al final lo barato sale caro. No entiendo las buenas opiniones, porque en mi caso tuve que devolverlos ya que en el primer fin de semana de uso se estropearon y entraba el agua sin problemas.	negative
Nos han encantado su buena apariencia y su calidad. Viene con unas cintas ajustables para las patas que impiden se las pueda llevar el viento. Parecen hechas a medida para un tresillo chino que compramos en un almacén de origen americano. Tienen unas asas para facilitar su colocación y unos bolsillos que esconden aireadores con redecilla para ventilar.	positive
Un juego muy caro para ser muy simple. Mala calidad de las cartas se estropean en seguida. Nada recomendable su compra	negative
El producto me llegó nuevo, en su embalaje en perfecto estado y con los accesorios correspondientes (cargador y auriculares) Nunca antes había tenido un iPhone, pero lo compré por el precio, pese a ser de 2015. Me sorprende lo bien y rápido que responde teniendo la ultima versión de iOS. El único pero, es que pese a que indica que la capacidad de la batería está al 100%, parece que se descarga muy rápido. Aun así, para ser mi primer iPhone, muy satisfecho con la compra.	positive
No vale para la yamaha Majesty 400 como compré. No me vale para nada. No encaja con los tornillos originales	negative
Muy profesional, se acopla al oído perfectamente y da un aspecto muy serio y profesional, me ha impresionado la calidad del sonido. Trabajo en una empresa que utilizo mucho el teléfono y todos mis compañeros me han preguntado donde lo encontré pero más se han sorprendido cuando les he dicho el precio, tiene un precio mucho más económico que otras marcas y la verdad no veo la diferencia habiendo probado ya varios. El cable del micrófono es flexible y además rota desde el origen verticalmente y horizontalmente.	positive
Son muy malas. Sobra funda por todos lados, se inflan al colocar el disco junto a los demás en la estantería y resbalan mucho. Hay otras mucho mejores y poco más caras.	negative
No me ha gustado del todo. Para tostar pan, olvidaros, mejor usar una tostadora de toda la vida y para sandwiches está bien, lo mejor de todo es que es fácil de limpiar, aunque si pones un sandwich con queso (por ejemplo) el queso se va a seguir metiendo en el mecanismo que une las dos partes, como en todas las sandwicheras. De potencia anda floja. No la devuelvo porque ya la he usado (una vez) pero no la recomiendo.	negative
La rapidez del envío, el libro es para un sobrino	positive
Buena relación calidad-precio. Solo una pega y es que son algo más grandes que los auriculares originales y pasado un rato pueden hacer daño en la oreja.	positive
Hay que ser constantes y los resultados llevan su tiempo, ni tan blanco nieve ni como los tenias antes	positive
Se ajustaba lo descrito pero tampoco del otro mundo	positive
Es un timo, no vale para Samsung s7, no lleva la curva que cubre toda la pantalla. No vale para Samsung S7.	negative
La pulsera llegó rota. Era un regalo y quedé fatal. No lo recomiendo a nadie.	negative
Tome la temperatura de mi bebe 3 veces seguidas y 3 temperaturas distintas daba. Lo mismo hice con mi marido y conmigo, no coinciden nunca y da hasta 1,5 grados de diferencia. Necesito algo preciso para mi bebe de 2 meses. Lo he tenido que devolver	negative
Un desastre es la segunda vez que pido mi guitarra y no me traen! Un desastre!!	negative
A no ser que seas experto en vinilos y demas pegatinas grandes, es muy complicado ponerlo, no vienen instrucciones, una vez despegado ya no pega, quedan muchisimas burbujas lo pongas como lo pongas y en el momento de pegarlo si le das con la uña mismo deja rallas, totalmente decepcionada.	negative
Lo compre para el cumpleaños de mi sobrino y fue todo un exito, lo recomiendo llego en el tiempo estimado.	positive
Brillo da, pero como jabón no sirve, no hace nada de espuma, cero, vamos...Yo lo he usado tras lavar con pistola de espuma, que sino....hago una guarrería, es como lavar con cera. voy a intentar devolverlo	negative
Al mes de comprarlo se me rompió la tecla de R1 y ahora tengo un bonito pisapapeles naranja.	negative
Libro de bolsillo, de pasta blanda. bien encuadernado. Y con la portada ilustrada. Es el que estaba buscando para el niño.	positive
Aunque es un buen producto el que me llegó parecía que había perdido propiedades. No olía al producto original ni el pelo queda sedoso. Parece cómo si estuviese pasado.	negative
Es entretenido pero no es como el juego que yo conocía. Las caras no se enganchan bien entre si. Practicamente, solo puedes hacer cuadrados o formas rectangulares,más o menos grandes, pero sueltas ya que al intentar engancharlas se sueltan.	negative
Lo esperado. Muy útil.	positive
El producto está bien, dentro de mis esperarías dentro del importe. He de decir que una vez recibido me resultó un precio muy alto a diferencia de otros productos de la misma línea, pero aceptable... Por otro lado y totalmente mal es recibir el mapa de GPS para usarlo en la pantalla y ver q el formato en el q viene el mapa GPS no es capaz de ser reconocido por la pantalla en cuestión... Saludos	negative
Llego liado como una alfombra lo deje unas 48 horas para que cogiera su estado normal. Para dormir uno todavía ya que te hace dormir en medio de la cama. Pero para dos no sirve, ya que hace que las dos personas caigan en medio imposible ponerte solo en un lateral. No recomendado	negative
Me ha llegado un día antes de la fecha prevista	positive
Demasiado pequeño. Apenas se puede leer	negative
Lleva dos días de retraso y ninguna explicación	negative
La funda es bonita y es tal como dice SLIM, pero dura poco. A mi hija se le cayo y se le rompio. Si no se te cae el mobil queda muy bien. Pero si no, mejor buscar que no sea de plastico tan fino.	positive
Hace tiempo compré este rascador y todavía lo tienen practicamente nuevo, y son dos gatas con muchas ganas de arañar. El color es muy bonito y la relación calidad-precio es muy buena. Sin duda alguna repetiré.	positive
Fue para un regalo y le encantó. Es un buen producto, llegó en perfecto estado	positive
Perfecto por el precio que tiene y el uso que le voy a dar es una maravilla recomendable 100%. La tela es muy suave y no pican para nada	positive
El producto llegó en perfectas condiciones. Facil de usar y con multitud de programa de lavados. Los lavados son algo largos si no utilizas el programa corto, pero por lo demás, todo perfecto.	positive
Después de pedir el producto, recibir color equivocado, devolverlo, contactar con el vendedor no recibir ninguna respuesta, volver a pedir, y volver a recibir el color equivocado me rendí, lo devolví ñor segunda vez, no puedo opinar sobre la calidad pero se ve normal, tarima de plástico imitación madera	negative
Faltaban 3 tornillos con sus tuercas y eso que venía bien precintado! He montado con unos del Leroy y ha quedado bien ajustado aunque todavía está sin probar con carga.	positive
La montura se ve recia y resistente, llevo poco tiempo con ellas pero parece que van a ser de larga duración y muy económicas.	positive
O me ha durado nada.ya la he cambiado por otra	negative
Algunos cartuchos la impresora no los cogía y los he tenido que tirar directamente, pero también es verdad que me costaron poco, por lo que no me ha molestado en exceso, pues es una impresora con más de 10 años y te sale esto más barato que comprar algo nuevo.	negative
Lo compré para mi Xiaomi Mi 9 y todo perfecto, fácil de instalar y buena calidad. Los recomiendo.	positive
Por el precio que tienen esperaba que no fueran especialmente buenas. Son demasiado rígidas y el mango se despega fácilmente.	negative
Lamentable experiencia debido a sus problemas de conectividad con la app. He comprado la versión sobremesa de este altavoz y al encenderlo y actualizar el firmware la app no lo encuentra. Lo peor es que lo he cambiado por otro y pasa exactamente igual, en cuanto lo actualizas de error. Un altavoz de esta marca y este precio no puede tener estos fallos... Lamentable	negative
Le pongo dos estrellas por qué no cubre en su totalidad la pantalla (no sobresale) el tacto es algo deslizante , la original que regalan con el teléfono se agarra mucho más.	negative
La talla L es correcta para 1.85 y 85 kg. Las mangas quizá un poco ancha pero nada que objetar.	positive
La sincronización era muy mala y poco alcance del bluetooth, deficiente	negative
Me ha decepcionado totalmente, no trae goma ajustable, tienes q atarlo con unos cordones y en las 4 esquinas no trae siquiera. Con lo que si hace viento se destapa continuamente. Además es de mala calidad, muy fino. Realmente no sirve para nada	negative
El mejor soporte de mesa que he usado para móvil. Elegante, se nota muy buena calidad y lo que más me gusta es que es portátil y viene con su funda para llevar. Me gustó tanto que compré otro para regalar.	positive
Es práctico para dejar los auriculares aunque me parece caro para ser tan simple,está bien cumple su función	positive
El producto parece bueno, pero la caja me ha venido en parte empapada, creo que por mal sellado del tapón, porque la botella no estaba rota, y venía bastante protegida. Es una pena, porque se ha desperdiciado bastante producto.	negative
Es el segundo libro de Ana Elena Pena que pido y cada vez me gusta más. Sin duda una de mis autoras favoritas. El libro es pequeñito para poder llevar en el bolso y se devora rápido.	positive
Por lo que me ha dicho la persona a la que se lo regalé, salen los gofres un poco sosos	negative
Me encantó, muy bonito y parecido a Hugo. De todos los funkos que hay de la serie es el que más me gusta.	positive
Lo tuve que devolver no le entraba corriente a la batidora, quizás pudo ser problema del cable, según leí en las instrucciones.	negative
El tacto es suave, a mi hijo y a mi nos encanta!	positive
Contenta con el producto, hace su función.	positive
Al principio pensé que no funcionaria, pasaron 2 días y no había caído, pero al tercer día ahí estaba el ratón, atrapado dentro y en perfecto estado, luego pude soltarlo en otra parte, cumple perfectamente su cometido.	positive
Me ha llegado abierto y aplastado >:(	positive
Esta bien, lo uso para colgar la bicicleta de montaña y va bien. Eso si, a la hora de instalarlo aconsejo usar otros tacos diferentes a los que trae	positive
Muy buena experiencia 100 % recomendable	positive
Lo recibí ayer y hoy lo devuelvo. En sí, no está mal pero a mí no me funciona bien. No se escucha los juegos que trae ni las películas del USB. La pantalla se queda enganchada y el DVD, a veces, da error de lectura.	negative
excelente siempre que la flauta se pueda abrir en dos partes es perfecta yo la hubiese hecho mas grande y alargada . eso si para las de plastico del colegio no valen	positive
Por este precio es más que recomendable. Las instrucciones se pueden encontrar en castellano fácilmente.	positive
No funcionan. Los tendré que devolver. Además, encargué 1 y me enviaron y cobraron dos.	negative
Me ha gustado lo bien que quita la grasa y suciedad del motor, y que no ataca a la pintura ni a las gomas. Lo que menos, como siempre el precio, son solamente 500 cl. y sirve para una vez.	positive
El colchón parece duro pero al despertar tiene un duda la parte donde has dormido así que te levantas un poco con dolor moviéndote al otro lado de la cama , lo malo que una vez abierto ya no se pueden devolver	negative
Acabado muy bueno, y mi hijo super contento de tener a sus personajes favoritos en un paraguas.	positive
Me encanta. Se limpia muy facil y el acolchado es perfecto.	positive
Compra perfecta.llego en el plazo y son muy como dos y no hay problema d q se pinchen como los tradicionales.Las única pega es el espacio q ocupan en la bolsa d la piscina.X lo demás genial muy biena	positive
Buena relación calidad/precio.Muy contenta con la compra.	positive
La cámara tiene una apariencia obsoleta. Ocupa mucho espacio con la pnatalla desplegada. No tiene un manejo cómodo. En mi casa ya venía abierta por el precio no solicité la devolución.	negative
Ha llegado muy mal embalado y golpeado	negative
Me ha gustado mucho, es muy bonito. Da mucho calor. Lo pedí para mi madre para que calentará el baño y genial y yo me he comprado otro. Muy satisfecha !!	positive
Buena terminación y a un precio ajustado. Lo recomendaré.	positive
Envio muy rapido, el protector parece que esta bien, encaja bien,lo unico que he echado de menos es el molde para colocar el protector y hacerlo mas sencillo.	positive
Es práctico...el móvil pesa menos y parece mas un s9 plus...lo hace muy bonito...deberia haber mas colores	positive
El embalaje ha llegado muy defectuoso, da la impresión de ser una caja abierta y devuelta por otro comprador pegada con cinta de celo por las esquinas, si no lo necesitase para un encargo hoy lo devolvería, da casi vergüenza regalarlo así	negative
Primeras pruebas positivas. Se escucha bien y la bateria aguanta mas de lo que pensaba, 6 horas mas o menos. Os ire actualizando la opinion si algo va mal de momento bien.	positive
Muy versátil, funciona bien con Android y con pc Windows. Con ps4 no he probado.	positive
Una telaraña barata pero que cumple muy bien su función y sus características. Es muy suave y no pica, en ocasiones he comprado otras telas de araña que picaban y esta es genial.	positive
Vienen 3 rotos por la esquina. Deben haber golpeado el paquete. El producto es según se describe. Pero una pena tener 3 estropeados sin haberlo usado.	negative
Es una muñeca muy bonita, es igual que en la foto y pesa muy poco. Perfecta para niñas pequeñas	positive
Mala compra. Plástico endeble, las bandejas no se enganchan y se sueltan cuando colocas o coges la ropa.	negative
Hace tres meses estas tiras en la placa ducha, despues de estar limpiando perfectamente la superficie donde iban pegadas, darles calor con un secador para que pegaran mejor y dejarlas un finde semana sin mojar se estan despegando las tiras dejando el adhesivo pegado en la placa ducha.	negative
1 dio la usamos y no funciona , la devolvimos	negative
En cuanto a diseño y materiales es muy top, no tengo queja alguna. Yo lo voy a devolver porque la esfera de dentro es muy oscura y cuesta ver la hora (esfera negra) incluso con luz, solamente se ve bien estando a oscuras; creo que es un dato que pocos han comentado y veo necesario. La app simple y cuesta encontrarla, también es algo tardía la vinculación con bluetooth, he de añadir que por el precio que tiene no son grandes pegas. Espero que os sirva de ayuda!	negative
No recibí el vestido que se observa en la foto, he recibido otro vestido de Dream Rover de color blanco.	negative
Muy útil y practico el comprar que por el peso que te lo traigan a casa.	positive
No realiza las expectativas, no ahuyenta	negative
Compre esta funda porque tenia una de libro y con el peque se hacia incomoda. Con esta funda y un protector de cristal templado todo perfecto y protegida	positive
Segun estaba descrito el monopatin parece que viene con el asiento incluido y cuando mo abres no es asi, para mi una decepcion creo q la informacion no es correcta e induce a error.	negative
Me ha durado un mes . Se ha roto la barra plateada de el lado. Me han mandado otra en 24 horas a ver si sale más buena	negative
Se rompe y no tiene servicio de garantia. Te devuelven el dinero y si cuesta mas el nuevo lo asumes tu.	negative
El libro viene acompañado de unas cuantas cosas más dentro de una carpeta de plástico transparente. Me di cuenta que esa carpeta tenía una pegatina-sello rota, la cual sirve que al abrirlo por primera vez se rompe, por lo tanto estaba abierto de antes. Desconocía si faltaba algo, tras comprobarlo con la tutora de mi hijo, todo estaba correcto. Daba la sensación de estar usado antes.	negative
Es una mochila grande, perfecta para llevar todas las cosas del bebé, pero algo incómodo para cerrar la cremallera principal, hay que cogerle el truco.	positive
Baja calidad del plástico	negative
Muy bonitos aunque pequeños	positive
La compramos nueva y nos vino una reacondicionada. Tiene un golpe en uno de los laterales. No la devolví por no desmontarla ya que era para un regalo. La silla parece de buena calidad, pero no me ha gustado nada que no fuese nueva.	negative
Muy completa, me gustó mucho.	positive
Las pinzas van muy bien. Desde que las he comprado no se ha vuelto a mover el mantel y no saltan nada. La única pega es que son largas y según donde las coloques pueden rozar con las sillas o las piernas. Eso hay que tener cuidado	positive
El producto no me llego, no sabemos dónde está. Recibimos el mismo día otros paquetes de Amazon pero este nunca lo localizamos. Lo siento, no se como indicar por otra vía que no llego	negative
Mis hijos de 3 y 6 años se lo.pasan pipa	positive
Lo que se espera de un producto asi. relación calidad precio esta bien. El envio según lo esperado.	positive
Muy mala compra, la tapa no baja bien y suena al bajarla	negative
El producto es el esperado pero su precio en las mismas cantidades es inferior en varias farmacias de mi zona	negative
El envío correcto. El CD muy aburrido. No lo recomiendo	negative
"Bueno, pues me han durado menos de 4 meses. Puntualmente me daban problemas con el micrófono, hasta el punto de tener que desconectarlos y volver al modo ""manual"" para poder mantener una conversación con el teléfono (android). Lo último ha sido que de estar funcionando bien ambos auriculares, sin razón alguna, el auricular derecho ha dejado de funcionar. No encuentro ni posibilidad de garantía ni de devolución, con lo que no recomiendo en absoluto su compra. Saludos"	negative
Buena calidad precio	positive
Los zapatos cumplieron ampliamente con lo anunciado. Son cómodos, la talla es la indicada y los colores son idénticos a la fotografía. Estoy muy contenta con el producto	positive
Todo perfecto. Envio mas rapido de lo que ponia. Volveria a comprar sin duda.	positive
Relación calidad precio muy ajustada. Funcionan bastante bien	positive
Me han llegado sin apenas filo, entiendo que no son formones profesionales pero al menos que tengan un buen filo para que corten.	negative
Producto de alta calidad y a un precio inmejorable. Muy contenta con la compra realizada. Muy recomendable	positive
Funciona perfectamente con el. Windows 10. Buena calidad.	positive
El plástico es muy malillo. Por ese precio la verdad es que no se puede esperar mucho, pero no volvería a comprarlo. El sonido tampoco nos convence, casi no se oye.	negative
Están muy buenas y a muy buen precio	positive
"Lo quería haber devuelto porque se puede subir un escalón pequeña pero no sé me ha brindado la posibilidad por tanto me lo ""como """	negative
Leí el primero súper rápido. Este se me hizo un bodrio total.. pero bueno mis expectativas tampoco eran tan altas	negative
entrega correcta y funciona muy bien pero la botonera va un poco tosca, tanto va rozando como luego no va tocando	positive
Me han entregado hoy los paneles, doblados como podeis ver en las fotos. Como dicen, una foto vale más que mil palabras. No parece haber una forma de hablar con el vendedor así que tendré que devolverlos.	negative
El protector no cubre la parte trasera por completo. La ranura para la cámara es demasiado grande y queda al descubierto sin protección	negative
Al poco tiempo de recibir dejo de funcionar	negative
Ha llegado la caja rota y aplastada. El funko tenía zonas son colorear y otras manchadas de otro color. La verdad es que ha sido un desastre de compra.	negative
El subwoofer no funciona. He estado intentando configurarlo con distintos programas y ayuda de varios informáticos y no hemos podido. He intentado contactar con la empresa y tampoco dan solución.	negative
El despertador no funciona.	negative
Alguno de ellos están como quemados ,es como plástico quemado,en alguna esquina. Son cómodos,lo único malo,es como si me hubieran puesto alguno con tara.	negative
Pone que me lo han entregado hoy y o es verdad me han traído una funda del movil note 10 nada mas	negative
Compré este spray para limpiar el ordenador y era el más grande y barato. Desgraciadamente la presión del aire es muy pequeña y apenas tiene fuerza para expulsar la suciedad más pegada en comparación con otros sprays.	negative
El producto responde a nuestras necesidades si bien debía darse la posibilidad de comprarlos por unidades sueltas, pero son de metal con un buen acabado.	positive
Muy completo y entretenido	positive
Realiza la labor que promete, tiene buena aspiración, tanto en alfombras como en suelos duros, y pesa poco. Lástima que la duración de la batería sea tan corta. Si pudiese durar por lo menos 1 hora, sería perfecto.	positive
no lo encontraba en las librerias y an un momento te lo mandan a casa si lo se antes....	positive
Cartas de muy baja calidad. Fichas pasables.	negative
Excelente para entrenar, me pedí la M pero creo que me venía mejor una L, la sujeción muy buena y buen acabado.	positive
Cascador de la marca cocodrilo. Como parte positiva, la facilidad de uso, al principio se rompen todos los frutos y las cáscaras salen disparadas pero cuando se le pilla el truco se le coge velocidad, se dejan de romper los frutos y las cáscaras de quedan sobre la mesa. Como parte negativa, el precio que es algo caro y con variaciones.	positive
Para el precio que tiene,no me parece que haga milagros.No lo compro más.	negative
Perfecto ,fácil de colocar y limpian de maravilla.	positive
Bonito diseño, pero apenas coge emisoras, por lo que solo lo estaba usando con usb conectado. No lo recomiendo. No lo recomiendo, al final después de unos meses hemos comprado el altavoz de alexa, que me proporciona mas variedad de música y calidad.	negative
La mitad de las luces Led no funcionan y los globos explotaban, como si estuvieran pasados. No los volvería a comprar. Muy decepcionada.	negative
estupendas fundas de agradable tacto y de muy buena calidad.ajustan perfectamente y el móvil no resbala de la mano como con las de gel.	positive
No cumple mis expectativas, hay que partir las piezas, de verduras sino no funciona correctamente, olvidar zanahorias	negative
Funcionamiento correcto y sin averias	positive
Fácil de montar, muy cómoda. Parece resistente, al menos de momento	positive
Necesité un par de intentos, pero conseguí averiguar cómo usarlo para rellenar mecheros. Pero, una vez hecho eso, va perfectamente.	positive
No volveré a compra a este vendedor no se adiere bien y quedan muchas burbujas de aire	negative
Buena presentación, pero se ve un material de mala calidad, lo devolví	negative
Precio calidad bueno	positive
Hecho de plástico de no muy alta calidad.	negative
Muy recomendable. Ideal para viajar con los mas peques. De buena calidad. Viene con unos rotuladores y unos juegos para colorear muy entretenidos. Lo volveria a comprar	positive
Me lo enviaron 2 veces y las 2 con la talla equivocada ,lo devolví por segunda vez y no lo volví a pedir	negative
Se calienta mucho y solo se enciende una parte de la bombilla, lo he dejado una hora y sigue igual. Tal vez esperaba otra cosa.	negative
El paquete llegó ayer viene muchas telas surtidas de diferentes colores. Esta bien para trabajos manualidades , las telas no son muy buena son muy finitas	negative
He recibido la carpeta, pero hay suciedad por la parte frontal y las manchas no se limpian	negative
Muy bien para empezar a leer en mayúsculas	positive
Hace mucho tiempo que uso este arnés para mis golden retriever y es muy fuerte y duradero, lo recomiendo	positive
No se si es por el transformador o el pedal pero me hace sonar al amplificador un mosquito horrible que no se si habra roto las válvulas del vox ac 15. Me gustaría poder saber si el problema es del pedal ya que lo compre segunda mano por 4 euros más barato que el nuevo. Esperando que estuviera seminuevo que lo esta, pero también que sonara seminuevo.he oído muy bueno as críticas de este pedal así que algún fallo debe haber.	negative
Buenos dias Resulta muy pequeño para sacar el polvo, lo cual no se aprecia en las fotos Por lo demás bien.	negative
En relación calidad precio es adecuado. Era para un regalo y he tenido que arreglar la goma porque si tienes la cabeza grande , como era el caso, aprieta. Por lo demás perfecto.	positive
Los e comprado hace dos meses y aún no me han llegado..!!	negative
Cuando piensan devolverme el dinero llevo dos semanas esperando para cobrar si cobran rapido vaya mierda no vuelvo a comprar	negative
Perfecto y sonido de calidad un 10	positive
Todo bien, sin problemas en recepción y condiciones del pedido, se adecua a mis expectativas sin problema, he quedado satisfecha	positive
Esta bien calidad precio	positive
Lo compre para un bmw e39 del 2003 y no se conecta con el coche asi que para mi no vale para nada	negative
me parece una estafa enviar algo en el estado que estaba sin micro y sin funcionar, estoy muy descontento con la compra y encima cheque regalo, no encuentro lógico nada de todo esto, sufro una molestia y me encuentro con la espalda, me ha disgustado mucho este producto y la devolución del mismo.	negative
Las patas se me rompieron en 2 meses, soldadura de patas baratas	negative
Con el paso de los meses de le hizo una raja y el vendedor me mando otro nuevo gratis.	positive
Queda genial ,es finita pero para vestir la cama es ideal.	positive
El producto como tal sin sorpresas. El envío, sin embargo, llegó con UN MES de retraso cuando se suponía que llegaba en dos días	negative
lo volvería a comprar	positive
Buenas tardes! He recibido hoy el pedido y aún no he comprobado si está todo correcto por ese motivo quería comentarles que la empresa de paquetería no ha envalado el producto, es decir lo he recibido en su propia caja sin ningún tipo de embalaje exterior, no sé si es lo correcto!!	negative
Producto defectuoso, ni arranca. Mal servicio por parte del vendedor y de la compañía de transportes.	negative
Llegó antes de lo previsto y por el momento todo perfecto. Lo utilizo para ver Kodi y genial!!!	positive
Cumple con el objetivo que yo buscaba lo suficiente. Se adapta bastante bien y permite apreciar el acabado del ipad	positive
He recibido el producto en perfecto estado. Parece de buena calidad y resulta fácil de poner en la cama. Las medidas encajan perfectamente con las de mi cama así que genial. Ademas viene en una bolsa de plástico con cremallera muy practico.	positive
Cuando el artículo es de bajo coste ni caso hacen	negative
Tardó mucho en llegar pero valió la pena. Por el precio no se puede pedir más aunque el cierre del cuello no es el mejor.	positive
Las bolsas son de muy b buena calidad, no se rompen y resisten muy bien. Ideales para perros y gatos	positive
Muy contento ,son unos auriculares muy comodos ya que son ergonómico y sobre todo muy ligeros, con un buen sonido.	positive
La mayoría de los parches se despegaron en poco tiempo . Muy mala calidad aunq os parches Sean bonitos . Tuve que comprar pegamento textil para que se quedase bien	negative
Calidad precio muy bien	positive
Aunque llegó dos días tarde esta todo correcto y en perfectas condiciones	positive
"El artículo es de calidad, está hecho para durar y sujeta de forma firme el talón. Sin embargo, entiendo que la venta es fraudulenta, pues el título ""Calcetines"" da a entender que la venta es por pares y no es así. El precio es para un calcetín. Está indicado en la descripción, pero no de una forma razonable. Me sentí engañado al abrir el paquete y dejo por aquí el aviso a navegantes"	negative
Bastante decepcionado, el giro no es como me esperaba es un producto bastante mediocre. No recomiendo su compra aunque tenga precio asequible.	negative
Es bonita pero yo pensaba que era una caja de las que les das cuerda y ella sigue tocando, esta tienes que darle continuamente para que toque la canción	negative
Me mandan un producto que no coincide con el pedido.	negative
Viene de China o algún sitio de estos... Eleva las pestañas y las multiplica porque contiene pelos sintéticos q se te quedan pegados a las pestañas... cuando llevas varias pasadas se empiezan a apelmazar y a los pocos días el producto se vuelve pastoso y se empieza a secar... no creo q sea original... y si es original no merece la pena en absoluto...	negative
Mi peke esta encantado	positive
El libro es muy bueno, fundamental para aprender lo básico en perspectiva. Pero la forma en que trata Amazon los libros es desastrosa. El libro ha llegado con las tapas dañadas y con las esquinas dobladas, algo inadmisible en productos de estos precios.	positive
Cuando empiezo a pegarlo en los rodapies sucede que la cinta de carrocero es más flexible que el papel al que está pegada por lo que tengo que estar pegando cada 4 cm la cinta al borde si la separación es mayor , la curvatura hace que se generen pliegues y que no se haga una linea recta	negative
El producto cumple con todas sus expectativas. Pero al ser de bolitas si que se hace un poco rígido; pero es fácilmente amoldable. De momento lo uso para dormir estando embarazada; pero se ve que cumple todas sus funciones. Muy recomendable.	positive
El producto está bien, sigues las instrucciones fácilmente, lo pegas y no se mueve. Yo quería que los ganchos fueran más finos, pues es para colgar collares y abalorios. Pero sirve para productos de más peso, ideal para la cocina u otros usos. Estoy contenta con la barra. No le doy las 5 estrellas por lo de los ganchos, pero esto era mi idea solamente	positive
Muy buena calidad, llevo años comprando de esta marca sus productos y me siguen gustando sus calidades de todos ellos.	positive
Yo no he debido tener suerte, los compré por las 5 estrellas que tenían, pero en mi caso los bordes no se pegan ni aunque se lo pidas por favor. Las fotos no son muy buenas pero se ve claramente que el borde está despegado. Tampoco ocupa toda la pantalla del móvil. Como los acabo de comprar no sé si acabaran despegando...el tiempo lo dirá, pero en principio no los volvería a comprar.	negative
La verdad es que no me llegó, aunque si que es verdad que me devolvieron el dinero rápido y sin ponerme ninguna pega, ofreciéndose para volver a Mándame el producto de nuevo.	negative
MUY CONTENTO CON LA COMPRA DE ESTE MONITOR SE VE DE FABULA	positive
Llegó antes de lo previsto y excelente en relación calidad / precio, parece de muy buena calidad el cable ( mejor que el original )	positive
Comprado (2 pares) 11 de julio y a fecha de 20 de agosto ya tengo un par con roturas en la parte del tobillo. No me lo explico. Le doy bastante utilidad, 2 veces a la semana para dar clases de boxeo cinco días a la semana. Pero no me ha pasado nunca con ningunos calcetines. Tienen muy buena pinta, pero no aguantan el rose con la zapatilla. No los aconsejo para los que le vayan a dar mucha tralla.	negative
Un engaño no sirve para nada lo tienes que hacer todo tú, no escurre nada o tan apenas, y tampoco puedes llenarlo mucho porque toca el escurridor. Buscaré otra alternativa este lo devuelvo.	negative
El articulo llegó antes de lo indicado. Nos viene genial!!! Lo hemos comprado para un familiar que esta enfermo y permite que la persona que lo cuida este realizando otras tareas en la casa y cuando lo necesita, solo tiene que pulsar el timbre. Tiene varias melodias. Es facil de usar y tiene un radio de acción amplio.	positive
De momento funciona bien	positive
Un desastre. Vino con un tornillo sin la muesca en la cabeza por lo que no se puede atornillar. Otro tornillo se partió por la mitad cuando lo estábamos atornillando. Muy mala calidad. Solicité la devolución con recogida. Se pasaron el siguiente día laborable en un horario en el que yo no estaba en casa y no han vuelto nunca más. De esto hace ya 10 días.	negative
Llegó el día pactado. Está muy bien por que entra mucha cantidad de pienso, con un día abierto al aire es suficiente para eliminar el olor a nuevo, es verdad que es de plástico, ya lo pone en la información del propio producto, pero esta muy y es robusto y cómodo con las ruedas.	positive
En las fotos se ve muy bonita, color rojo que fisicamente parece rosa y un efecto espejo por la parte trasera que en realidad es un trozo de plástico de mala calidad. Personalmente me a decepcionado bastante la calidad del producto típico de una funda de 1,50€ de china.	negative
Es un libro genial. Excelente. Absolutamente cuidado y muy bien editado. Respecto a su contenido es realmente maravilloso y ameno de leer. La primera parte de las dos en las que el autor lo ha dividido, es magistral. Muy respetuosa con nuestros clásicos matemáticos. La segunda parte, la matemática nueva, es impactante, el tema de las conjeturas matemáticas por las que podemos aspirar a resolverlo y ser premiados con 1 millón de dólares y el reconocimiento. Pienso que esta Segunda parte será ampliada con seguridad. ¡Fantástico!.	positive
Te alarga la pestaña pero es horrible cuando te poner el más pequeño se te meten eso pelitos en los ojos y es super incómodo a mi no me a gustado	negative
No suena bien, hay notas que no deberian de ser asi, además el sistema de la manecilla esta flojo, has de apretarlo manualmente para que gire más rápido y suene a l nivel de la canción sin que tengas que reventarte la muñeca. La estética no está mal, aunque me vino con una pequeña parte rota.	negative
Tal cual la foto, quizas el muñeco mas grande, es muy grande en relacion con los otros, pero son de buena calidad y me gustan.	positive
Alumbran mucho, si viajas de noche son 100% recomendables. Tienes que poner el faro en la posición mas baja para no deslumbrar a otros conductores, pero merece la pena por seguridad tenerlas instaladas. Otra cosa es pasar la ITV... que habrá que desmontarlas para evitar problemas.	positive
Huele raro, no puedo decir la eficacia porque el olor me disgusta y la he regalado.	negative
No entra en mi sofa y el vendedor no contesta a mis mensajes	negative
No cumple con su función. He realizado pruebas con un vaso de agua, y para sentir saciedad con dicho producto necesitarías tomarte 10 pastillas por toma.	negative
Calidad media bien para su precio	positive
Es dura y fragil y viene sin colchon.....cuando la compre se veia en fotos con colchon.	negative
Funciona sólo hasta 4k 30hz. Me hubiera gustado que llegara a 60hz pero no lo hace. Ahora lo empleo con una tv 1080p 60hz y perfecto.	positive
El cepillo se para cuando quiere ya me lo han cambiado en Amazon dos veces tengo que decir que por la parte de Amazon muy amables pero lo que es el cepillo por mi experiencia propia no sé si ha sido una remesa que han salido con defecto pero me ha tocado a mí estoy muy descontento con este cepillo si fuera ahora no lo hubiera comprado	negative
Llegó perfecto en tiempo. Las primeras dos veces funcionó muy bien, la tercera se encendió, hacía ruido, pero no se hinchaba... Lo devolví gracias a que dejó de funcionar a la semana, no sé que pasaría si se te pasa la fecha de devolución.	negative
Dejó de funcionar a la semana	negative
Perfecto para vinos (blanco), para un combinado se queda corto si te gusta bien frío.	positive
A mis hijos les encanta y es menos endeble que el de m&m	positive
Son comodas pero muy anchas, no me ha servido para rectificar desviaciones	negative
Viene a durar mas o menos lo que una batería original. Hago un uso poco intensivo del móvil y con una carga completa me dura entorno a un día y medio. Producto recomendable.	positive
Rápido por Amazon y buen producto para secado de audífonos automático deshumidificador , calidad y precio, estupendo	positive
Delicado y bonito tamaño adecuado. A mi mujer le ha encantado.	positive
Se fijan con arandelas a presión y por eso no se sujeta bien y producen ruido. Debieran llevar tuercas.	negative
Por parte de amazon como siempre 10 , el producto llego defectuoso, pude solucionarlo y me hace el apaño asi que no me voy a tomar las molestias de devolverlo , pero llego roto.	negative
El producto cumple lo esperado. Veo los canales de euskaltel emitidos en abierto	positive
Llegó pronto y queda perfecto	positive
Esta desajustado se atrasa se lo he llevado a un relojero me dice que abrirlo ajustar y cerrarlo cuesta como el valor del reloj	negative
Los personajes son muy originales y la calidad de las piezas con sus colores han encantado a mi hija	positive
No la recomiendo para una mujer, mas bien para una niña. Es demasiado fina.	negative
Se adapta perfectamente. Es un poco rígida, pero aún así es muy comida. El kit viene con los destornilladores pero no trae los pasadores.	positive
Muy completo para ese precio	positive
Es más bonito de lo que parece en la foto y no pesa nada. Recomiendo	positive
Muy bonita y especial aunque sea un poco cara.	positive
Tiene buena pinta, veremos cuando lo usemos. La votación media/baja es porque la funda viene sucia, como se aprecia en las fotos	negative
No sirve ayer la resibi y nada no funciona no cumple con su trabajo los mosquitos pasaban por mi como si nada lamentable compra no lo recomiendo en absoluto ...!!	negative
Al principio bien, pero luego un auricular le costaba cargar y el sonido era cada vez más bajo, los he devuelto, con 15 días de uso	negative
Son pequeños pero quedan bien muy rapido	positive
La talla no corresponde, es muy pequeño	negative
Son bonitos y se escucha bien, pero no sirven para PS4 porque no traen el adaptador que se supone que traen. Los compré 2 veces por si era un problema de envío, pero no, el adaptador no viene.	negative
El cartucho de color no imprimía como si no tuviera tinta	negative
Es válido para el passat Variant 140 cv de año 2006 lo único que cambia es la posición de los cables pero está muy bien para el precio y lo que te ahorras con el original y no veo mucha diferencia. Lo único que deberían protegerlo un poco más para que no se raye	positive
Un poco difícil lavar	positive
Se supone que llegó, pero entregaron otros paquetes y no ese. Enseguida amazón reaccionó y ofrecio la reposición o la devolución.	negative
La cámara tiene dos grandes ventajas: primero, las lentes y las luces de visión nocturna no pueden verse. Segundo, la configuración es simple. La cámara es muy buena de usar, la imagen es muy clara. Realmente me gusta la reproducción de bluetooth de la cámara, es muy agradable para escuchar música	positive
Lo unico malo es el peso, por lo demas perfecto	positive
Muy cómoda , la batería dura muchísimo y recibe las notificaciones bien, en cuanto a los pasos ect no es muy exacta xo xa el precio q tiene no está mal	positive
Funciona bien, pero no para todos los vehículos. En un Focus 2004 no he tenido problemas, pero un Scenic 2002 no llega ha leer los datos (creo que para Renault se necesita uno especial), en Opel, Nissan y Subaru no he tenido ningun problema e incluso he llegado ha borrar algun error que tenian. Se comunica bien con la app Torque que es el único que he probado.	positive
No me ha llegado todavía	negative
Tuve que cambiarla porque una de las asas estaba mal cosida. Cuando llegó el reemplazo parecía que estaba correctamente cosida pero en apenas un mes de uso (agosto o se ha usado) se ha vuelto a descoser!	negative
Satisfecha con la compra recomiendo funciona perfectamente.Cogi dos y cumplen bien su funcion.Material como los mandos plastico pero buena calidad	positive
Artículo que cumple todas las funcionalidades esperadas a un precio realmente bajo. La única mejora sobre la cual deberían trabajar es el facilitar el acceso a los botones laterales de bloqueo y control de volumen. Por lo demás perfecto.	positive
Fácil de colocar y buen resultado	positive
No ha llenado nunca, un timo en toda regla	negative
Excelente retenedor de puerta. Lo tengo anclado a La pared y soporta corrientes fuertes de aire. Evita tener que agacharse a poner y quitar la cuña cada vez que abres o cierras la puerta.	positive
100% recomendable el producto y el vendedor. Empresa muy seria, me informaron del envío y plazo de entrega en todo momento.	positive
El palo de tan ligero que intenta ser, se convierte en frágil. Apenas ha durado unos días, después se ha empezado a romper... Los hay de mejor calidad por muy poco más.	negative
Hola el color de las manillas de piel que aparece en la publicidad no es el mismo y no estoy satisfecho por la compra gracias	negative
La calidad del sonido es muy mala. Prefiero gastarme más dinero pero que tengan más calidad	negative
Desde el primer día no ha funcionado bien, sufre reinicios constantes, cuando la bateria baja del 30% no se enciende y la suspensión no funciona. No recomiendo comprar productos Chuwi	negative
Un libro que engancha desde el principio. Da a los personajes mucha vida e intensidad, con toques de humor. Sin duda volveré a leer a esta autora	positive
Pésima calidad, No se puede poner la funda( se levanta las esquinas) en cuanto le puse la funda los dos protectores se rompieron. NO LO RECOMIENDO.	negative
Crei que era nuevo, porque tenia un precio igual que uno nuevo.	negative
Me llegaron antes de lo que decían, los he probado y en principio se parecen mucho a los originales tanto en el sonido como en el tacto de los mismos. He comprado en muchos sitios y en éste el precio es asequible y buena calidad.	positive
¿Por qué se envía el artículo sin embalaje? Daños y grietas en todas partes :(	negative
Se lo entregaron a quien no era tuve suerte y la vecina me lo dio	negative
Los he usado y de momento me van muy bien. Son fuertes y tienen la ventaja que son de acero inoxidable. Espero que duren y que con el uso no se aflojen.	positive
Yo no he notado ni mejora ni empeoramiento. A mí no me ha funcionado.	negative
PARA NADA ES COMO EN LA FOTO. NI ES REBORN, O NO LO PARECE, NI EN PESO NI EN DETALLES NI NADA. MUY CARO PARA LA MUÑECA QUE ES. TOTALMENTE DESCONTENTA.	negative
El molinillo funciona muy bien, muele fenomenal, lo malo es que la tapa se cierra de forma segura antes de que pueda funcionar, y ese cierre de seguridad es el que se rompe tras unos meses de uso. He tenido que comprar otro molinillo igual sólo por la tapa, y ahora ya tengo muchísimo cuidado y espero que no se me rompa otra vez. Espero que mejoren la calidad del cierre de la tapa.	negative
Encaja bien en el movil y es tal y como se presenta en la foto	positive
Sonido de llamada telefonica se escucha muy bajo y sonido musica bien pero se corta varias veces	negative
Muy bonito., calentito y comodo para el bebe	positive
Al conectar uno de los dos tubos, uno de ellos se rajó a lo largo debido a que el plastico estaba pasado y se había quedado quebradizo	negative
Defectuoso desde el primer dia	negative
Buscaba una esponja konjac para probar y este ser me pareció de lo más interesante. Viene un par de 3 esponjas, que tienen un cordel para colgar y una ventosa para ponerla en la pared, así dejar que se seque. Viene plastificado.	positive
La cortina es muy bonita .pero es muy corta	negative
Una estrella hasta solucionar el problema. Abri la caja en el suelo con muchísimo cuidado, porque yo para esto hago hasta un ritual (con lo que mola abrir cajas grandes de estas...) y vi que el plástico del lado inferior del apoyado derecho está roto. Me podéis mandar apenas la pieza? O tengo que devolver toda la silla? Gracias.	negative
No es la versión de España , así que no sabría decir si es igual , viene de Italia , se lo dije a Amazon que deberían de especificar eso y así el cliente elige si comprar o no	negative
yo compre el pack de 5 y en menos de 2 meses se me han averiado 3 unidades, los otros 2 están a punto de fundirse, el draiver aguanta bien pero la tira de led se funde, a mi parecer el driver le da demasiada caña al led y este tiene una vida corta por el sobre voltaje y el sobre calentamiento que tienen. no la recomiendo, en cuanto se me fundan los otros dos se los devuelvo a amazon.	negative
Buena idea pero mal construido. El soporte no es suficiente fuerte para el peso de la manguera y el uso de ella, se fue rompiendo el solo, y con un uso normal.	negative
Las bombillas las solicite para coche y el casquillo es mas pequeño no es el estandar	negative
Lo primero es que me llego en otro idioma al solicitarlo ( en francés) y aunque se equivocan ellos ya tengo yo que sacar tiempo para acercarme a al sitio que me digan en el horario que lo tengan abierto y hacer la devolución. No me parece que sea un precio justo por el reloj que es y los materiales que tiene, plástico y cartón. no me ha gustado mucho y no lo recomiendo. El sistema para aprender las horas no lo puedo valorar, pero lo veo como otros, nada especial.	negative
Los valores son bastante precisos al compararlos con otros aparatos que tengo	positive
En la foto viene con flecos rojos y lo mandan con flecos negros, no entiendo porqué	negative
Tal y como describe el anuncio	positive
vale cada euro que cuesta, la bateria dura muchisimo, yo no lo he cargado desde que me lo compré y le doy mucho mucho uso... es genial.	positive
No me gusta porque no afila las tijeras, es más me ha estropeado dos pares!. Los cuchillos tampoco los deja bien y para el precio me parecen los resultados poco satisfactorios.	negative
La bateria dura bastante. El sonido esta bastante bien aunque esperaba mas bajos. Lo unico negativo que veo es que solo se emparejan si estan dentro de la caja, asi aue hay que llevarla siempre encima por si se desconecta del movil que alguna vez me ha pasado	positive
Producto bien detallado luz blanca com o especifica lo único mal es a la hora de la fijacion el pegamento no pega bien y con la húmedas se despega, por lo demás bien en esto el vendedor no es el culpable	positive
la pinte quedo preciosa	positive
El Plato giratorio es suficientemente rígido y el sistema de rotación suave. Las espátulas tienen un equilibrio bueno entre robustez y flexibilidad y las rasquetas son aceptables. Como Detalle negativo, la madera no tiene unos acabados pulidos. MUY BUENA COMPRA.	positive
son muy debiles. cuesta abrocharlos y son muy pequeños. Pero si que brillan cuando les da la luz. No los volveria a pedir	negative
Que no me ha llegado todavia	negative
La cámara funciona bien y buena calidad. La conecté por wifi. Es la app la que me ha hecho devolverlo. Se traba, el aviso de alarma suena en la cámara y en la app un aviso como cuando te llega un correo al móvil. No nos sirve para controlar la habitación de nuestra abuela por si se levanta de madrugada. Lástima. La he devuelto.	negative
la calidad parece buena , cumple su funcion , con pescados de escama muy fina no es tan eficiente	positive
Es un juguete que no me gusta nada y creo que los niños lo piden porque les hace gracia pero no vale nada. No lo volvería a comprar. Cómo mucho el precio por esto sería de 5€ como máximo	negative
Para casa, ya que pesa poco	positive
fabuloso escalón para la cocina y alcanzar a los estantes mas altos	positive
Da poco aire y enfria muy poco ,no deja de ser un mini ventilador sin potencia ,caro para lo es	negative
Son un poco mas grandes y menos suaves que los que suelo comprar en la farmacia. Pero cumplen su funcion igual. Lo recomiendo.	positive
MAL! Llame para cambiar la dirección de envío y en principio todo arreglado. Me lo trajeron antes de la fecha estimada, no me enviaron ningún correo para avisarme ni me llamaron para confirmar que estaba en casa para recibirlo (tal y como me habían confirmado que harian) y me lo enviaron a mi dirección antigua. Total que no lo he recibido en mi domicilio. Muy mal!	negative
He pedido cuatro relojes de esté mismo y me parece una barbaridad que me cobren el envío por cada uno no debería de ser así por que pedí los cuatro a la vez y para la misma dirección es una pasada que hagan eso así	negative
La verdad que es una maquina de niebla perfecta para eventos fiesta de cumpleaños!me ha sorprendido porque es pequeña y fácil de transportar además te viene con dos mandos uno portátil y otro de pulsador lo cual me ha llamado la atención!! Lo único que tiene poca capacidad pero si es para cositas pequeñas de eventos es perfecta !	positive
Misteriosamente me anulan el pedido sin mas explicaciones y me retiene el dinero el tiempo que amazon estime. Acojonante.	negative
Perfecta ,llego pronto y en buen estado, la recomiendo es la 2 que compro y las dos llegaron bien y listas para ser usadas, recomendable	positive
El producto vino rallado por lo que supuse que ya lo habían utilizado, aun así, le dí una oportunidad, cuando lo conecte todo iba perfectamente, compartía teclado y ratón entre dos pc's portatil y sobremesa, pero a la semana dejo de compartir tanto el teclado como el ratón por lo que lo tuve que devolver, una pena me hubiese servido bastante.	negative
Esta en perfecto estado, tanto la caja como el cartucho del juego. Tenía muchas ganas de jugarlo en mi Nintendo 3ds. Gracias😊	positive
Es cinta, no hilo. Por eso no me gusta.	negative
Mi tío es cazador y buscaba algo asi para los perros , este le va genial y funciona muy bien, el perro no sufre y aprende a comportarse con este collar de adiestramiento	positive
me parece una opción perfecta, para dar un toque vintage y cuidar de la cámara al mismo tiempo. cara, si!	positive
Una de las tablas venía con un pequeño rasguño. Por lo demás, excelente	positive
Bien empaquetado, justo a tiempo y sin sorpresas	positive
Es más grande de lo que anuncian, aún no sé que tal será, personalmente no me gusta que pongan unas dimensiones que no se correspondan con la realidad, así que espero que el resto que anuncian sea real.	negative
Lo único negativo nque le encuentro a las pinturas de Vallejo es que son demasiado líquidas.	positive
El producto cumple con la descripción, buena calidad	positive
La traducción es pésima y la historia para adolescente o menos edad .. no be gusto nada este libro debe estar en el género casi infantil.. un timo de libro.	negative
Anécdotas simples que no enganchan en ningún momento. Tratándose de anécdotas de la guardia civil, esperaba más contenido en el libro pero el autor se limita a una descripción muy superficial de las historias	negative
Compré medio número más, como indicaban otros compradores, y me ajustó al pie perfecta. Es más cómodas que otras alpargatas ya que con la suela de goma y su ajuste te permiten andar con ellas todo el día.	positive
El producto no me llego, es una estafa.	negative
Se ajusta bien aunque el aparato para ajustar la pantalla no cabe bien en el iPhone 11 pro Max. Se notan muchísimo las huellas incluso nada más ponerlo. Incluso se le pega el polvo a la pantalla. La he tenido que tirar.	negative
El asa superior,se ha doblado,ni idea como...pero es imposible colocarla en su posición.Por el precio que tiene,lo demás bien....no se que ha pasado con ese problema.To utilizo con poco peso	negative
Todo perfecto es justo el modelo para mi coche por el precio de una pieza de desguace tenemos esta pieza Nueva Siento tener que decir que ha dejado de funcionar bien cuando quiere se encienden los cuatro intermitentes síntoma de que la pieza no está bien	negative
Fácil de usar, y buena calidad imagen, lo uso en una tableta y todo ok	positive
Hay consejos útiles y otros de relleno pero es en plan cómic y queda divertido. Lo metimos en una cesta de bebé y le dió el toque gracioso entre tanto babero,gel y demás enseres.	positive
De momento van perfectos y cargan rápido, no le doy 5 estrellas hasta ver lo que duran en el tiempo.	positive
Horribles. Se agrietan los labio en cuanto te pones.	negative
Correcto. Lo esperado de la marca staedtler. Envio también perfecto.	positive
La pelicula 6 y 8 no vienen con audio español 😞 Decepción pues ponia en idiomas que estaban todas incluidas en castellano	negative
No fue la calidad que esperaba, se rompen con bastante facilidad ya que son de plástico, tengo otros de metal y ya los puedes trastear que se pela la pintura pero en esta ocasión, no ha sido la mejor elección	negative
El TTL funciona perfectamente	positive
Cumple con lo descrito	positive
Aún no me ha llegado el producto, así que de momento mi valoración es muy negativa, a ver si me llega mañana	negative
Huele bastante, lo utilizo en el humidificador	positive
El producto no mantiene la carga a la final cuando lo vas a usar las luces no van. Por eso la puntuación se compran para lucir las luces pero si no funcionan es un zapatilla normales.	negative
Muy mala calidad. Acabado imperfecto. He tenido que pegar una parte. El vendedor ha reembolsado casi todo el importe para no tener que recoger el producto. No lo recomiendo.	negative
Bastante fastidiado, pierde mucho la conexión con el portátil los puertos usb, el hdmi por ahora bien, pero repito, se corta la conexión por la cara con el tiempo. Si encuentro la caja lo devuelvo.	negative
Es bastante bueno y resistente. Se conserva correcto se podria mejorar, resistencia correcta pero mejorable. Lo malo, el ancho y que el sistema de cierre a las 30 veces de cerrar se tambalea y suena	positive
Libro en mal estado no se como contactar con el vendedor sin tener que darle a la opción de devolución el libro me corre prisa porque es para trabajar con el el colegio	negative
Tamano grande y de goma espuma. El material esta muy bien. El paquete tardo en llegar pero han sido muy amables y me han devuelto el dinero por haber llegado tarde. Recomentable para aquellos fans de Minecraft.	positive
No ha llegado todavía y tenia que haberlo hecho el 25 de julio	negative
Para mí Citroen Xsara Picasso le haría falta algo más de ancho por lo demás bien el belcro bien pero el acolchado nada si tela compras si el es lo miy	positive
Esta funda se adapta perfectamente al Ipad y su imán es potente en la solapa. A mí me resulta un poco enclenque cuando lo pliego para que me sirva de soporte. Con el tiempo se van despegando un poco las capas de la cubierta. El IPad se me ha caído varias veces y lo ha protegido bien	positive
No soy de criticar pero este grifo/ducha aunque muy economico y vistoso no vale la pena. Se oxida por dentro y peor, tiene fugas continuamente.	negative
Todo según la descripción, nos llegó en castellano y con la luz (lámpara) tal y como lo pedimos, muy satisfechos.	positive
Era para un regalo y no me fijé que la part de abajo no tenia tirantes. Era muy incómodo y lo tuve que devolver.	negative
Es una maravilla! Lo malo es q la cerveza sale cara, pero es un lujo poder tirar tu cerveza en tu casa!!	positive
El precio un poco excesivo	positive
Son los que mejor agarre he tenido pero en un mes sin apenas uso se me ha descosido en los dos guantes la tela y con lo que cuesta no merecen la pena.	negative
Perfecto,buena calidad para el precio!	positive
Compré esta funda para el iPhone 8, al principio muy bien y bonita. Pero al cabo de unos días esta la parte trasera toda rallada y color amarillento de la funda . TODA UNA DECEPCION DE ESTE PRODUCTO. NO LO RECOMIENDO PORQUE NO ES BUENA CALIDAD	negative
Un aerógrafo perfecto calidad/precio La única pega, el compresor se mueve mucho por culpa de la vibración.... Yo le pegue 4 gomas un poco más grandes y listo....	positive
Novela que engancha casi desde el principio, buena narrativa y capítulos muy bien guiados para mantenerte en la historia sin cansarte	positive
Buen relación calidad-precio. Y un sonido bastante aceptable.	positive
Sencillo de instalar, fácil de poner y quitar el móvil. Se mueve un poco con los baches	positive
Pensaba que sería estupendo para mí piel pero no ha sido así. Indica un alto grado en vitamina C pero no he notado prácticamente nada en el tiempo que lleva utilizandolo ( aproximadamente 1 mes ).	negative
Encantada con la compra. De momento, puesto que aún es pronto para valorar la durabilidad, todo perfecto. Lleva algo menos de dos meses y por el momento, ok. Las anteriores, de otra marca, venían durando entre 8 y 9 meses, así que no puedo comprobar la durabilidad.	positive
Lo voy a devolver. No funciona	negative
Envío muy rápido. Excelente producto. El tiempo que la he utilizado ha respondido perfectamente. Compraré otra.	positive
Muy fáciles y las soluciones se ven a simple vista, no te hacen pensar mucho que es lo que queremos los opositores..	negative
Más de la mitad me llegaron rotas en varias partes muy pequeñas. Las uso como complemento a un producto que vendo y logicamente no puedo entregarlas así. Muy descontenta	negative
Gran libro narrado de manera muy clara, con base científica perfectamente citada y referenciada, y muy fàcil de leer. Me ha parecido muy ilustrativo y pràctico. Lectura obligada para todos los docentes	positive
No me ha llegado. Casi 6 € tirados a la basura. Muy mal	negative
Se cae enseguida en cuanto se seca	negative
Llego con una patilla rota y se abre sin permiso. El motor funciona bien pero el plástico es malo.	negative
Efectivamente son de cerámica y de muy buena calidad la cerámica. El mango es de plastico pero no pesa . Corte firme y eficaz. Buen producto.	positive
El cable de alimentación USB es de pésima calidad. muchas veces no funciona ni conectándolo directamente al mando. La conexión en la base es endeble. Tiene holgura. Cuando colocas el mando en la base, se ilumina la luz que opuesta a la que que al menos a mi me parecería lógica (mando mas alejado de los testigos es el que ilumina más cerca del primer mando). por 8 € más estaba el original de Sony. No merece la pena. se ha estropeado en 4 meses, en un sitio donde nadie lo toca....	negative
Gran calidad, fácil de usar y duradero. Lo tengo hace 3 años y continua funcionando como el primer día.	positive
Justo lo que necesitaba. Ha cumplido mis expectativas. Buena relación entre el precio y la calidad. Recomiendo la compra de este producto	positive
Es un aparejo muy bueno, rápido, preciso y fácil de usar. Tiene una buena pantalla. Llegó muy rápido. Estoy muy satisfecho. Recomiendo 100%	positive
Aunque el material parece un poco más endeble de lo que esperaba, si cumple su función perfectamente. Uno de los enganches para el recambio de cepillo no ajusta bien y a veces se sale pero no siempre. Por lo demás fácil de lavar y secar.	positive
Le compré una para mi hijo y al tiempo le pedi otra para mi sobrino, buena compra si señor.	positive
Excelente por el dinero que pagas. La bicicleta es muy buena para la conducción ligera, pero no la recomendaría para ningún sendero de montaña, ya que no tiene suspensión. Fácil de ensamblar, pero si tiene problemas, simplemente eche un vistazo a YouTube y encontrará toda la ayuda que necesita.	positive
Este artículo núnca fue recibido.	negative
Cumple perfectamente con lo ofrecido	positive
Buen producto, funciona correctamente	positive
Todo correcto. Articulo según descripción del proveedor. El producto llegó en la fecha indicada. Recomendable . Envío ágil.gracias. volveré a comprar.	positive
Es muy bonito pero lo elegimos entre otras opciones por tener las hojas más gruesas, sin embargo no puedo utilizar rotuladores con ellas porque se transpasan. Algo decepcionante.	negative
No se pega bien a la pantalla se despega a los dos día.	negative
Solo me llego una parte, que devolví con ña autorización del vendedor através de SEUR. Desde hace 20 días estoy esperando y reclamando el reintegro del importe cobrado. Dicen que no tienen nada pendiente. Tendré que recurrir a que amazon me lo reintegre	negative
Chasis y ruedas correcto, pero el sillín es plástico y muy fino además para ajustarlo es necesario utilizar la llave inglesa... El acabado esponja delantera es muy simple, trozo tela encima de una esponja... Las tapas de las uniones bailan y fácilmente muestran las tuercas.. Los tapones para los tornillos de las ruedas se pierden fácilmente. Buena apariencia pero falla en los detalles... Fabricación china	negative
Mis magnéticas favoritas para diario	positive
Muy buenos encajan perfecto	positive
Nos encanta . Extraordinaria mesa , excelente calidad de la madera y su aspecto es buenísimo . Fácil de montar y muy bien protegido para posibles daños . Muy felices por la compra . Gracias .	positive
El volumen ca por su cuenta...es muy complicado regular volumen y cambiar de menu....no lo volveria a comprar.	negative
NO HA TARDADO NI UNA SEMANA EN ROMPERSE	negative
Exageradamente ruidosa, no cumple con lo que dice en la descripcion.	negative
No funciona la escucha de mensajes	negative
No he encontrado grandes recetas. He hecho varias y no han sido los mejores panes que he hecho. He encontrado mucho más información y mejores recetas en internet. El libro no tiene ni índice.	negative
El producto se da mucho mucho de si Crece mucho con el uso No hay calidad con el tiempo... Y en hawaianas nunca me había pasado esto	negative
Lo he usado poco pero incluso con el lavado de 90 min los platos han quedado estupendos.	positive
Es practico pero no carga bien... lo deje una noche y solo cargo a la mitad y se calentó muchísimo el teléfono. Funciona si pero no tiene una buena carga. Para momentos puntuales está bien y así la clavija del teléfono no sufre. Lo recomiendo pero no para uso habitual	negative
De muy buena calidad	positive
Es una funda magnífica, el tacto que tiene es muy agradable, da un aspecto de calidad ya que están bastante bien cuidados los detalles y terminaciones. El único pero es que tal vez tiene un precio algo elevado.	positive
Exactamente el cortador de cutículas perfecto. Tamaño ideal, buena relación calidad-precio. Buen diseño y buena calidad. Cómodo en el uso.	positive
Encaja perfecto en el uppababy 2015. La cesta es muy grande y siempre la llevo llena de cosas que no quiero que nadie vea y así no llevo bolso de carro porque a mi me molesta. Parece de buena calidad y me encanta que pueda doblarse cuando guardas el carro en el coche.	positive
Sale un poco más barato que cualquier sitio de venta y por aquí tiene la opción de Copa que esta muy chula	positive
Muy bonitos, pero se rompieron a la segunda vez puestos y NO SON IMPERMEABLES	negative
Es una buena marca, reconocida, la proteina está muy bien, pero el sabor chocolate blanco... no me estraña que estuviera rebajado, es muy malo. Tiene de chocolate lo que de paella. Recomiendo 100% scitec, más barata y con sabores mucho más logrados	negative
Perfecto para el aspirador	positive
Es una auténtica mierda .... Daña la pintura del coche y deja unas manchas que no se pueden quitar	negative
Producto fiel a las imágenes y auténtico	positive
Las roscas vienen algunas mal hechas y otras no entran	negative
Bonito funko, me ha gustado mucho ya que me encanta la serie. Le pongo 4☆ en vez de 5 porque la caja ha venido tocada y no esta en un estado impecable.	positive
Lo uso para el café de cada mañana que me llevo a la oficina, cómodo, tamaño perfecto para bolso y conserva muy bien la temperatura. Lo recomiendo para uso diario.	positive
No sirve para nada y además llegó destrozado	negative
No llevo un día con él y ya se han despegado la mitad de los velcros del árbol. En la primera puesta han fallado. Además, la calidad es ínfima. No vale 12 euros ni de lejos y no merece la pena comprarlo.	negative
buen material, parecen resistentes. cumplen su función. contento. ya he comprado varios en casa, tanto en blanco como en negro.	positive
Es muy bonito y huele muy bien, como a melocotón, pero no ha durado ni media hora y se ha roto por tres sitios distintos sin a penas manipularlo. De todas formas tengo dos o tres de proveedores distintos y son todos igual de malos. Una pena.	negative
Deja rallas en los cristales o no se usarlo o no sirve...	negative
Esta funda para móvil es semirrígida en la parte interior tiene una ranura para poder guardar una o varias tarjetas protege bastante bien el móvil y tiene una posición para poder aguantarlo de pie	positive
Las compré porque iba a hacer un viaje a Costa Rica, y según parece la B1 ayuda a crear en el sudor alguna sustancia que no les termina de gustar a los mosquitos. La verdad es que era estación seca, pero aun así, no nos ha picado ninguno, no sé si habrá tenido que ver. La presentación es en un paquete, no un bote, pero vamos, no hace falta más.	positive
No me han llegado todas las piezas pero ya estava casi toda montada cuamdo me e dado cuenta, me falta el numero 7, la podre utilizar igual pero ya no me dara el mismo uso	negative
hay llegado muy bien empaquetado y muy rápido, pero la calidad es bastante mala, los dibujos parece que los hayan pintado unos niños con rotuladores desgastados.	negative
Lo compré porque mi tarjeta gráfica se calentaba y hacía mucho ruido, pero al intentarlo montar no era compatible ya que en la descripción no dice que tarjetas son compatibles.	negative
Es muy liquido parece tinta china	negative
El precio me ha gustado pero el.color no tiene nada que ver con la foto y además son como de tela muy mala imitación del.ante	negative
las cosas como son, gran producto, gran envio, mejor precio. recomendado para emular en tu pc videojuegos retro o para raspberry. botones, material, tacto, etc, todo perfecto, tengo 4 en casa y los 4 funcionan.	positive
Tarjeta microSD Kingston muy buena, como siempre bajo la garantía de un buen fabricante como es Kingston. Buena compra, recomendable para todo el mundo.	positive
No sabía manejarlos , pero enseguida lo conseguí . Estoy con rehabilitación !	positive
Esta muy bien en cuanto a medidas pero no ha durado ni un telediario, no lo recomiedo.	negative
La lámpara emite un pitido cuando está en funcionamiento, es muy agudo y casi imperceptible pero molesta cuando todo está en silencio. La intenté cambiar y no pude, era un lio... Por lo demás, funciona bien, la luz se regula de fria a caliente y de intensidad.	negative
Perfecto, cumple su cometido	positive
La cremallera vino medio rota y terminó de romperse a los pocos días. Se nota la mala calidad de la cartera	negative
es muy grande y poco cómoda.	negative
Llegó en 3 días, muy potente el chorro de agua, tengo un hueco en la zona de una muela del juicio que me quitaron y han salido trozos de comida que tenía alojados en dicho hueco. Buena compra	positive
No me ha llegado aún y me tenia que haber llegado ya no se ha que es debido no se	negative
Ha venido muy pronto, el material es optimo y ya esta puesto y funcionando. A mi no me han llegado las diez abrazaderas metalicas que se ven en la foto, no se si por olvido del vendedor o por que otra razon. Aun asi me ha servido muy bien.	positive
Cumple con lo que me esperaba dado el bajo precio, es decir un kit que se podría adquirir en cualquier ferretería . Eso si, la entrega muy mala, tardaron mas de 15 dias y nada de información al respecto.No lo recomiendo si tienes prisa	negative
La mochila me llegó en el tiempo indicado por correo. La mochila está bien, la calidad del dibujo no es como aparece en las fotos, es mas baja.A mi hijo le ha encantado ya que le encanta fortnite.	negative
Quedan preciosos, son pequeñitos. Pero muy lento el envio...lo pedí la semana de Reyes y llegó en Febrero...era para un regalo y aunq bonitos llegó muy tarde	positive
Muy muy malo... De una calidad pésima. No lo recomiendo en absoluto, es horroroso, la verdad es que no se cómo ganan dinero con esto	negative
Es perfecta. El motor hace un pelin de ruido, pero hasta sirve para relajarse	positive
Tengo dos olivos en el jardín que quiero iluminar de forma decorativa, vi estos focos y aun que soy un poco desconfiado en este tipo de iluminación decidí comprarlos, el envío fue rápido y bien protegido, mi sorpresa fue al abrir los y comprobar que físicamente superaba mis expectativas, parecían de muy buena calidad y de tamaño ideal, los probé y me gusto mucho la potencia de luz justo lo que necesitaba, además tienen dos intensidades de potencia de haz de luz, perfecto, muy satisfecho de la compra	positive
Por el precio que vale está bien, es algo endeble, no se debe usar si hay viento y para montar uno sólo no es complicado, mínimo 2 personas	positive
Calienta mucho para un piso pequeño, me parecía estupenda. Pero a las tres semanas de tenerla se ha fundido una de las barras, con lo cual no la recomiendo.	negative
es muy comodo de utilizar	positive
Definitivamente no soporta fondos de cartulina y menos de vinilo, por lo visto esta diseñado únicamente para fondos de tela de máximo 2 metros. Para el colmo llegó defectuoso ya que las secciones de barra no se podían bloquear.	negative
Tardó una eternidad en llegar, cambiaron dos veces la fecha de entrega, no lo entregaron (tuve que recogerlo en Correos) y vino en paquete desde China (¿?). Para eso lo compro más barato en Ali express.	negative
un bonito reloj, fue el regalo favorito del niño este cumpleaños, tiene muchísimas funciones y lo recomiendo 100%	positive
Se apaga la imagen y difícil regular.	negative
Suaves y de buenos materiales pero no validos para plena lactancia ya que enseguida se rebosan y te empapas	negative
Muy buen producto, cómodo y fácil de utilizar	positive
Pues eso. Y que se me perdone mi descaro, pero es el cuchillo todo propósito que necesitamos el 99% de los aventureros. No más. Duro, práctico, efectivo, económico... hasta bonito. Para más fardar, existen auténticas filigranas, claro.	positive
Muy utiles para llevar los zapatos en maletas, mochilas...	positive
No me ha gustado, porque no puedes poner mucho peso, las ruedas se abren.	negative
El diámetro del filtro es más pequeño que él de la fuente original Catit, con los cual no sirven para nada porque no filtran el agua y además al quedar espacio libre el motor de la fuente de escucha mucho más.	negative
Conecté la radio y hace una especie de interferencia en los altavoces.El conector de micrófono externo viene doblado hacia un lado.No volveré a comprar esta marca	negative
La única pega es el tipo de pilas que utilizan,por lo demás para el uso que le doy(EMERGENCIAS) cumple genial su función y ocupa muy poco espacio dentro de mi equipo habitual.RECOMENDABLE	positive
Silla cómoda para oficina. Cumple las expectativas. Yo mido 1, 78 y el reposacabezas me queda bien.	positive
Pone que es para iPhone 7 pero no cabe en él la han hecho más pequeña y intentaba poner mi móvil y no cabía	negative
los comentarios son reales van muy bien	positive
Perdón la reseña no era para este producto.. Aún estoy provandolo. Gracias	positive
Muy cómodo, muy buen sonido. Un acierto comprarlo. Además, siendo la conexión con usb, mejora la conexión y acceso desde todo tipo de portátiles.	positive
Es un libro muy completo y muy bien ilustrado, sin duda un manual excelente !	positive
El diseño es bonito y aguantan perfectamente toda la noche sin escapes.no huelen absolutamente a pis y son suaves	positive
Ni 30 min lo usé la app SKY no funcionaba e intentando conseguir que arrancase , murió el aparato, Amazon 10 en la devolución	negative
No me sirve. El color es mucho más claro del que sale en la fotografía y era para la nevera	negative
Es un timo, solo sirvió una vez. Me siento estafado. Un robo nunca más llegó a funcionar este aparato, ESTAFA	negative
Con algunos datos médicos más o menos conocidos, los autores plantean que no es tan complicado tener una vida sana y feliz en condiciones normales. Algunas precauciones, algunos cuidados, algo de mesura en la mesa y generosidad en el ejercicio y puede que vivamos más y mejor de lo que lo estamos haciendo. La receta de la sensatez.	positive
Pese a que es un producto barato deberían ser mejores, se rompieron en 2 días	negative
De momento la primera,me a durado una hora de fresado en dm.....no es muy normal ya que es un producto caro y tendria que ser de calidad...veremos lo que dura la de remplazo que me a enviado amazon.	negative
Mal producto, llego dañado con una raja que casi no se veia, el embalaje estaba perfecto y parecía efectivo por lo que entiendo que lo enviaron asi, lo cual es peor aun. El pegamento se notaba de la mala calidad. Doy 2 estrellas porque amazon actuo fenomenal y devolvio el importe rapidamente.	negative
Actualmente los tengo instalados en mis patines de linea, mas o menos desde hace medio año y la verdad que no tengo queja ninguna sobre su calidad y utilidad. la verdad que son mucho mejores que los que tenia instalados anteriormente. por mi experiencia en patinaje y por como a salido el producto si que recomiendo su compra. Espero que os ayude mi opinión, un saludo	positive
no es el producto adecuado	positive
Una vergüenza, 2 veces me han enviado el redmi5 en vez del note 5	negative
No han llegado, y el vendedor no contesta por mas que pongo mensajes. Creo que es un timo! Un saludo	negative
A parte de que las imagenes mostradas engañan bastante respecto a su tamaño, 2cm (era de esperar, puro marketing). La calidad del colgante deja bastante que desear por su parte posterior que está totalmente hueca.	negative
La pedí morada y ha llegado la azul, encima cobrada al precio de la morada. La descambiaré.	negative
Es el mismo contenido que el otro tomo de civil war pero que añade un extra de páginas con diferentes ilustraciones de portadas de su desarrollo. Es una pena que aparezcan en el integral y no en el otro, ya que desentona un poco el lomo con el resto de los tomos. Compra acertada en calidad y contenido.	positive
Aunque hay funciones que no tiene	positive
el tamaño es ideal para poder manejar con piezas pequeñas. la lima plana, al ser la más fina, haciendo más presión de la cuenta se rompió por la mitad, pero me sigue sirviendo igualmente. las demás limas, triangulares o redondas se ven más fuertes.	positive
Lo he devuelto. Se queda bloqueado a veces. Imagen muy blanquecina. Lo compré para ver movistar tv y da error al abrir la aplicacion, y cuando la abre alguna vez, la imagen muy blanquecina. Youtube lentisimo y eso que tengo fibra y lo maximo de velocidad.A parte se veia que ya estaba usado por todos los rayajos que llevaba el protector del aparato	negative
Justo lo que buscaba a un precio inmejorable. Tiene piezas para juanetes y arregla perfectamente cualquier calzado. Parecía más endeble pero no he tenido ninguna incidencia después de muchos usos.	positive
Por este precio es difícil encontrar algo mejor. Queda muy bien en el teléfono y es un plus de protección ante arañazos.	positive
La puse 1 mes, dudo que sea cuero... acabo pegajosa y sin olor. El iman esta muy bien pero se te puede soltar si se despegan del acero, ya que son dos imanes pegados en ambas partes del cierre. Para mi es cara por el tiempo de uso que le di.	negative
muy cómodo, blandito y gustoso al tacto, lo único pensaba que era un poco más grande, pero el error fue mio al no mirar bien las medidas, así que por lo demás perfecto.	positive
Funciona muy bien. Y la utilizo diariamente. Extravié una pieza sin querer y el fabricante me la proporcionó gratuitamente. Muy contenta con la compra.	positive
La imagen es más bonita que el producto. Tenia un descosido	negative
Un poco pequeño si quieres meter muchas cosas, pero para botiquín básico perfecto. Muy bonito.	positive
El círculo de detrás no coincide del todo con la manzana de apple y se queda cortada. Por lo demás, para el precio que tiene bien.	negative
en la Nikon D 750 me permite el disparo para fotografía lenta, enfoque a mitad de trayectoria del botón	positive
Relación calidad/precio muy buena. No es el mejor producto de la marca que he tenido, pero con ese precio no se puede pedir más. Aunque no tienen reducción de ruido la verdad es que aíslan mucho, solo hay que elegir el tamaño adecuado de almohadilla.	positive
El paquete a venido medio abierto,no venia dentro del paquete	negative
No es un cargador de carga rápida	negative
El espejo en sí es pequeño, pero t acostumbras, son fáciles de montar, y quizás por eso también de robar, barato pero aerodinámico, válidos para otros modelos de piaggio zip	positive
Cuanto llega .La caja esta podrida	negative
Llegó con signos de estar abierto aunque aparentemente bien empaquetado por dentro. Lo probé según instrucciones y no aguantaba ni 10 segundos encendido, haciendo unos pitidos insoportables. Después leí críticas y lo devolví dando por hecho que venía defectuoso. La devolución rápida y sin problemas.	negative
Todo perfecto tal y como esperaba	positive
Es perfecto para un niño de 3 años	positive
Buena relación calidad precio. Hace tiempo que la tengo y estoy contenta con ella	positive
El pedido ha llegado en el día indicado y funciona correctamente	positive
Estaba buscando el de adultos y encontré un estupendo libro juvenil. Me lo leí y se lo he pasado a mis hijos, es una buena historia.	positive
Estan muy bien por el precio que tienen, para practicar y abrir candados, taquillas y alguna cerradura que otra van de lujo, no son unas ganzuas premium pero como cerrajero les doy un 8, vienen muchas para diferentes tipos de bombines.	positive
muy bien, bonita mochila todo perfecto	positive
No me gusta, deja el pelaje algo aspero	negative
Perfecto tal y como esperaba llevo una cámara de 29 y varias herramientas tampoco se le puede pedir mucho más material bastante bueno se ajusta. A la perfección	positive
El juego es muy bonito y tal, pero jugarlo en la Switch no merece la pena porque el framerate no es muy estable que digamos	negative
Solo pega el borde negro, a los 5 min se despegó de la pantalla, dinero tirado a la basura. Y ni hablar del tactil... Ni funciona	negative
Auriculares con buen sonido y baja latencia, el pero es su durabilidad, pues apenas usados para ver la TV y ya suenan interferencias en el auricular izquierdo debido a mal contacto en el cable...	negative
Una de ellas ha venido con una muesca y por el interior no pega y queda un brillo como si no hubiese quedado bien. Ya he probado las 2 y ambas igual	negative
Más bien te las espesa q te las alarga. Y la fibra d seda se mete en los ojos y es un poco molesta.	negative
Como siempre está marca es muy fiable y de calidad	positive
Perfecto para transportar tus pertenencias, elegante y durarero.	positive
No me gusta por qué es espray de pintura roja.	negative
Magnífico, mi hermana quedó encantada. Al abrirlo no se lo podía creer, es muy facil montarlo, y queda muy estable.	positive
Buscaba un objetivo versátil para poder viajar sin tener que llevarme más objetivos y este cubre mis necesidades. Tiene un rango muy amplio sin perder calidad de imagen. Sólo apunto que es un poco oscuro y para capturas nocturnas o oscuras no responde como me gustaría, pierde calidad de imagen. Lo ideal es un objetivo para cada tipo de captura pero para viajar ya me sirve.	positive
Me ha llegado roto el cristal y sin la parte del LED ni el mando.	negative
El producto para precio no esta mal,el problema que el auricular derecho acaba de dejar de funcionar. Me pondré en contacto con Amazon,para una posible solución,pero ni un mes llevo con ellos	negative
De momento, todo bien. El cuerpo de la luz delantera da una sensación sólida, metálica y de cierto peso lo cual sugiere buenos componentes. La luz es sorprendentemente buena, con bastante alcance. Yendo en bicicleta de montaña se está cómodo, no da la impresión de que te estés quedando corto. La carga mediante USB, una comodidad. De momento, todo bien,	positive
calentito, buena calidad y pesa muy poco	positive
Muy contento con la compra. La calidad de la maleta es muy bueno, y si bien me esperaba que los enganches fueran peores (de plástico), son mejores (de hierro), por lo que aguantarán más	positive
ES DEMASIADO PEQUEÑO	negative
Génial, le gusta a mi hija	positive
Igual qué en papelería pero más barato	positive
La luminosidad muy buena, pero el tono demasiado cálido, me hubiese gustado un poco más blanco	positive
Me ha resultado de gran utilidad para el curso que estoy haciendo. Lleva incluido todo el pack entero, libro, dvd, workbook y un mini cuaderno que lleva un resumen. Lo recibi en perfecto estado.	positive
He tenido la oportunidad de probarlo con los cacharros del jardín estos días que ha habido mucha lluvia y mucho viento y la verdad es que ha aguantado muy bien el tipo, mejor de lo que esperaba, y eso que como digo ha hecho mucho viento. ni un rasguño a los muebles y completamente seco todo. fantastico la verdad.	positive
La calidad del producto es correcta. Protege bien el teléfono y le da una sensación de robustez. A pesar de esto no es tan robusta como parece (a los pocos días se salió una pieza que luego se puedo volver a colocar) Buena relación calidad-precio.	positive
Ha cumplido su cometido y finalidad.	positive
Nos desilusiono bastante, la diana muy endeble y se cae facilmente, el arco no vale nada y las flechas no hacen ventosa. Si lo sé, no lo compro.	negative
en cuestion de semanas ya no nos cerraba bien la boca para poder jugar, no estoy muy contenta con la compra	negative
El auricular derecho no funcionaba.	negative
Muy bonita, bien construida, buenos materiales, led muy útil, funda de transporte mullida...… pero NO CUMPLE lo publicado. Solo carga rápido por el USB Type C y no por el USB A. Comprobado con un Samsung S 9 + y con cables originales. Lo he devuelto.	negative
Encarga perfectamente en mi taladro	positive
Buen filtro y a un precio insuperable , protege la lente no sólo del sol s no de posibles arañazos.	positive
Buenos días Uno de los estuches para cargar los auriculares no funciona. Por tanto tengo que cargarlos de uno en uno.	negative
Mala calidad, mal cosidas	negative
son una capa muy gordita, la verdad sorprendente con un solo pañuelo, para tener en el coche o la mesilla de noche viene fenomenal	positive
Portada y contraportada en inglés, además el Beyond: Dos Almas no viene en español, tal solo el Heavy Rain da la opción de español.	negative
Son muy grandes y no caben en la ventana del coche.	negative
Pedí estas cremalleras y me llegaron nada más que 40 y de otros colores totalmente diferentes a los de la imagen	negative
Me vino sin el cofre y con la portada doblada. Lo verdad que resultó algo decepcionante ya que el resto de los tomos estaban bien.	negative
Un poco justo. Pedí una talla mas de la habitual y queda apretado. El interior desmontable no llega hasta abajo por lo que tienes que ponerte unos calcetines/medias altas. Un poco incomodo el broche del cinturon. Este broche queda en el centro y se te clava	negative
A mi hijo le encanta	positive
Buen precio y calidad desempeña su función	positive
Me lo pensé mucho antes de comprar este modelo, viendo que hay varias opiniones de personas a los que les dejó de funcionar por las buenas. Bien, pues a mi me han debido encasquetar uno de estos. lo compré, se supone que restaurado, pero ni enciende. Ya he tramitado su devolución y mirare otra marca y en otro lado	negative
Cumple muy bien su función. El diseño es muy chulo y la sujeción perfecta. Muy contento con la compra.	positive
Pelín ruidoso, pero da mucho viento	positive
No cubre en so totalidad la pantalla	negative
Buenos días, No sé si es esta plataforma donde me tengo que dirigir. He estado fuera de España estas semanas pero cuando he vuelto y he abierto el paquete que me llegó, he descubierto que uno de los cuatro contenedores estaba roto. ¿Qué debo hacer? Un saludo, Raquel	negative
Cumple con lo descrito. Buena relación calidad precio,si se busca para salir del paso cumple con las expectativas, recomiendo compra	positive
Empecemos por decir que la calidad de las costuras deja mucho que desear, sólo con ver cómo eran me di cuenta que no aguantarían al poner el toldo, tuve que hacer que las reforzaran, la tela no es de mucha calidad, a pesar de ser barato, no está acorde con su calidad.	negative
Huele muy bien y deja el pelo brillante y sin apelmazar	positive
Llegó con abolladuras y oxidado por alguna esquina	negative
Buenas noches acabo de comprar esta cámara y me parece buena compra lo único que por la noche cuando detecta movimiento cuando saca fotos y vídeo se ve La Luz roja de los infrarrojos,hay alguna manera de que no se vea ninguna luz?	positive
Nunca llegó....me devolvieron el dinero... Después de un mes de espera... No la volví a pedir	negative
Es lo que quería mi niña, se a puesto muy contenta y Feliz , yo veo que pesa más de lo que me imaginaba. El pelo por comentar algo no está muy acertado.	positive
Malísimos... La idea de estos productos para la lactancia es evitar mojar las camisas pero con estos discos es lo mismo que nada, siempre estoy empapada.	negative
No carga, desde un principio y nada mas recibirlo el cable de carga entraba como forzado y se veía claramente que la entrada de metal no coincidía con el orificio de plástico habilitado para esta (ver fotografía), pues al de pocos meses y con un uso casi ridículo, para que comience a cargar, hay que hacer verdaderas peripecias con el cable de carga. He reclamado la garantía al vendedor en dos ocasiones y tan solo ha contestado al segundo de los emails después de mas de 2 semanas y haciéndose el loco.	negative
Me ha durado 1 día! Y he seguido las instrucciones para no quemarlo. Simplemente dejó de funcionar	negative
Ideal para el verano reforzar la lecto-escritura y la comprensión lectora. 5-6 años	positive
Falta potencia para poder hacer los alimentos dentro del año en el que estamos, por que no veas lo lento que es...al final solo sirve para fundir el queso y ya..	negative
Pedi 600 bolsas y sólo han llegado 100 bolsas el resto se ha reclamado pero aquí me tienen a las vueltas	negative
BUENOS DIAS, COMPRE DOS PORQUE CONFIABA EN AMAZON, CREYENDO QUE LOS APARATOS ERAN DE CONFIANZA. PERO NO SIRVE PARA NADA, LO INSTALAS EN EL COCHE Y LA TEMPERATURA NO VARIA NI PONIENDO LOS DOS,EN LAS HORAS MAS FUERTES DEL SOL, ES CUANDO MENOS LE TOCA, PUES EL SOL ESTA EN LO ALTO Y NO LE TOCA PERPENDICULARMENTE A LAS PLACAS PUES EL MISMO APARATO TENDRIA QUE PONERSE LAS PLACAS ENCIMA EL TABLIER LUEGO EL SOL TE TOCARIA PERPENDICULARMENTE Y PODRIA TENER UN VENTILADOR MAS POTENTE. DESPRESTIGIA A AMAZON	negative
Funcional, económico y fácil de instalar	positive
Súper buena, ya que me gustan las cosas clásicas.	positive
Un teclado mecánico muy compacto que está a buen precio, pero el artículo que recibirás tendrás las teclas con la distribución inglesa. Si te sabes el teclado español de memoria y si no te importa darle a FN+teclas de direcciones cada vez que quieras usarlas este es tu teclado. De lo contrario necesitarás comprar switches para conseguir el teclado que se ve en la primera foto. Adjunto imagen para que puedan decidir y compara, ya que en la mayoría aparecen con distribución inglesa	negative
Se desliza de la nariz cuando duermes y puede caer si te mueves, pero hai que decir que si te acostumbras cumple.su función	negative
Es muy bonita. La relación calidad precio es muy buena. Su sistema de pila y de imán para pegar al techo va muy bien porque no tienes que hacer la instalación eléctrica. Queda muy bonita. La recomiendo sin ninguna duda.	positive
Me a parecido perfecta para el precio que tiene no se puede pedir más , muy buen material y calienta muy rápido	positive
Muy cara para lo que es... Por ese precio podría incluir unas gafas de sol o algo. Hay versiones muucho más baratas y mas practicas. La compramos para regalo, pero duele gastarse ese dinero en un trozo de lona	negative
El Pendrive indica 117 gb, pero no almacena más de 45 y además no permite su formateo en NTFS. Amazon debería tener más cuidado con estos productos	negative
La amoladora va estupenda, el precio también para el uso diario de mi marido está muy bien, el reparto como siempre super puntual.	positive
la estética y la calidad precio muy buenas la calidad de sonido y audio genial cable largo y botones útiles La comodidad es su punto débil son grandes y aparatosos y pueden llegar a ser incómodos y en verano dan calor	positive
Amazon te venden un disco duro de 10 tb y te mandan uno de 2 tb. Respuesta de amazon es que ya no lo tenian y por eso te mandan el de 2tb, para alucinar y cobrando como de 10 tb	negative
Cumple su función. Lo quería como auxiliar en la ducha para poder dejar cosas en una cestita y, en caso de necesidad, como taburete para ducharse si no es posible hacerlo de pie por enfermedad o accidente.	positive
El móvil es bueno y sirve para lo que queríamos, pero el teclado debería ser un poco más grande, y las teclas de funciones no son demasiado intuitivas	positive
No es tapiz , es una impresion en tela de camiseta.	negative
Me parece una lámpara fantástica. Muy cómoda y con buena luz	positive
Todo muy bien, perfecto, el paquete me llegó en tres días laborables, teniendo en cuenta de donde procedía muy bien de tiempo..., muy contento. Seguiré comprando por Amazon!!!	positive
Suave al tacto, y casi no necesita plancha. Las coderas de peor calidad	positive
Deja bien protegida toda la pantalla, y colocada la funda original samsung queda muy bien ajustada. Totalmente recomendable.Queda muy bien.	positive
Genial tras varios meses de uso sigue como el primer día. Cogí esta mesa porque mi pareja es muy alta y está genial porque no choca con las rodillas al elevar la mesa. Un 10	positive
Son perfectas estéticamente porque quedan con cualquier color ya que son transparentes. Peeeero se me han despegado al día siguiente.	negative
Llegó a tiempo y son de calidad. La única pega que veo es que un mes antes los bi en el lidel por 11 euros, pero son ofertas puntuales. Ajustaria más el precio. Por lo demás genial.	positive
Buen producto por el sistema de conexión rápida.	positive
Cumple con lo establecido	positive
Mi perro fue capaza de destrozarlo a partir de la segunda semana. Tiene mandíbula fuertes a pesar de ser pequeño. Todavía no encontré un juguete que le dure varias semanas...	negative
No sirve para lo que dice, no funcionaba en el coche, y al gestionar la devolución tuve que reclamar el importe de los gastos de envío de devolución (un 10 a la gestión de Amazon en esto, por cierto)	negative
Calidad bastante mala, poca eficacia de frenado y se gastan muy rápido por 6 € más te llevas unas galfer.	negative
Realmente sólo 2 de las 9 ramas miden 90cm. 4 miden apenas 20 cm y las otras 3 no llegan a 50 cm. Y las hojas son muy pequeñas. El color es bonito. Pero no se corresponde ni con la descripción, que dice que son 90cm, ni con la foto super frondosa. Por el precio no se puede pedir mucho, pero oor oo menos que no engañen en la descripción.	negative
No funciona el derecho	negative
Súper bien, lo e puesto en mi Audi a4 del 2004, encajan a la perfeccion	positive
Lo utilizo para entrenar por terrenos sencillos como pistas forestales, caminos rurales y senderos sin complicaciones técnicas. Alumbra muy bien, lo llevo siempre a intensidad media y las bajadas con su función de un toque en el lateral pasa a potencia máxima. En cuanto a la duración de la batería aun no he agotado las pilas que vienen, así que no puedo valorar.	positive
Perfecto, buena carcasa y enchufe	positive
La cámara no funciona, en mi opinión me han suministrado un artículo devuelto	negative
Son las únicas gomas que he encontrado q sean de buena medida y sujeten bien.	positive
CUMPLE LAS EXPECTATIVAS	positive
Silicona fuerte y un dibujo bonito. Llevo tres meses con él y se le han borrado un poco las esquinas, por eso no le doy todas las estrellas. Buen protector en relación con el precio	positive
La lámpara cumple con todos los requisitos, pero el adaptador para enchufarla me exploto al conectarlo a la corriente y como consecuencia saltaron los plomos de toda la casa.	negative
De los dos uno llegó directamente roto, el otro funciona aunque se le ve que mejor no lo toques mucho o se romperá también.	negative
Son muy cómodas, pero la verdad es que duraron muy poco, la calidad no es buena y se abrieron por varios sitios.	negative
Son muy cómodas,el número lo sabía por qué tengo unas del mismo modelo.Indican de q son de hombre pero soy mujer y me van bien.	positive
Da muchos problemas enciende cuando quiere me gustaría saber un servicio técnico para revisar no se ve bien solución ya	negative
A los dos meses de uso el micrófono del reloj no funciona. Se oye pero cuando hablas no te escuchan.	negative
